 新年要面对的问题地瓜@@ 	anger
 我真的很生气，全部被讲中，但就是偏偏戒不掉！比吸毒还难搞，嗨 	anger
。新年不單要餵街貓，連舖貓都要餵埋，真的離譜。 with Brian Wong	anger
Damn.....  怡保路釀豆付的鱼丸里竟然苍蝇(呕) ，老板娘只一句：不是我们做的，我和別人拿货的。⊙﹏⊙ 	anger
.而且, 預防勝於治療: 預防注射!	anger
 新北市政府請問一下：爲何拿大多數納稅人的錢，去點綴極少數人的家。這麼覺得的請分享 with 羽倢 at 新北市歡樂耶誕城.	anger
 這看到能讓妳不生氣嗎?生氣就分享吧~~為動[PERSON] 討個公道~~ 	anger
 既然整條高速公路都是儲蓄東的了！那是不是未來整個高速公路維修費用都要遠通自行來修復！不然憑什麼向民眾收取通行費！天底下有那麼好康的事嗎？[PERSON] 你真的還能夠忍受下去嗎？願意被搶劫嗎？而默認不出聲嗎？	anger
都是一样的哦~~~说没服务费~~~都是假的吧~~~	anger
他们利用和践踏。真的。无言。新加坡人。上等人? 什么来的?!Please share!!!!! with Alan Lee and Valerie Lau	anger
妈妈叫他移掉他的东西很久了!!!!那个是停车位来的!!!他还用椅子丢我妈妈的车,要打我妈妈(他是男生叻!!)最后因为很多人在看才把东西移掉的	anger
 芭離草黴竟然放了七包面紙在福袋中當成商品，其他東西不超過000竟然賣000，這是詐欺(話說我前兩個禮拜主持某手機品牌時，經消商也這樣包了幾包面紙福袋讓我送客人，是報應嗎??????!!!!) off.	anger
 Tmd,我明天要工作00小時耶，現在生病老天跟我開什麼玩笑，我不依我不依（怒摔藥）(￣^￣)ゞ at 中和劉全能診所.	anger
Naive girl posting words with her stupidity to the world.. Hahahaha  为什么世上还有这种畜生的存在？你知道你在说什么吗？你懂不懂什么叫尊重？以下是	anger
0000+)。一个没有工作经验的外劳也可轻易的赚取同样的薪水，这是什么道理？(摄于红山，0/0/00 国庆日，晨)	anger
 工作时，手被炸伤了… 	anger
係得蝗蟲會隨街疴屎呀！無蝗蟲咁做又點會放得大件事呀！吓！屎都忍唔到就咪忍出門曬股啦！！！ with 蝗母娘娘？...	anger
 莫怪我對你說話不算話……如果要怪就怪你自己當初先說話不算話你自己先說的到卻做不到…一拖再拖	anger
Thats crazy omg  離譜…… 害人會心安嗎？連累他人，害人精快點消失這世上！賤格,超級變態 ：(	anger
 不好的心情 	anger
So funny ! Even fill up petrol need to bring payslip  改装无罪(v) 发觉马来西亚政府越来越可爱了，这样也想得出 off.	anger
Walao....  不要再吃KFC 和 PIZZA HUT 了！ 大家一起教训他们吧！ 	anger
吧！p/s: 写这篇存粹是因为不爽那个男负责的态度。。 off 	anger
 最爱的黑色,今年竟然是忌,买了好多黑衣,怎么办 	anger
－00顆玻璃瓶純植物提煉國外國內認證合格［不放心，可送檢驗哦！產品有投保0千萬］。－假貨－00顆塑膠製公司明稱標榜不實　超低價我已經查到好幾款了哦！仿冒一定必究。請為了人家健康著想，你如果家人吃到你們會爽嗎？已經吃了那麼多的黑心油，黑心食物，還不讓台灣人身 體健康！在仿冒騙人............. 全台灣人咒你去死啦！ at 台灣人就是要支持ＭＩＴ(...	anger
 這兩天情緒比較不好看到感動的戲就會落淚就說吧，感情別輕易談下去連我去夜店玩都有你眼線別用你那社交圈威脅我老娘明天晚上就是要去 at 溫暖的被窩裡.	anger
 一個多小時在車上跟楊巧愛抵抗!! 真的會讓我氣瘋氣到發飆罵她卻害我被老公罵！當媽咪真的很可憐、孩子大小事都要處理一歲小孩力氣竟然比我還大、打從出生就不愛坐娃娃車跟安全座椅！逼她坐簡直要她的命！現在她是哭到聲嘶力竭累挎只好乖乖就範！ at 國道一號.	anger
ㄦㄞㄦㄦㄞㄦㄦㄦㄦㄦㄦㄦㄦㄦㄦㄦ  塞0娘，自己帶不好，還怪到我頭上，什麼叫沒看過我這樣的媽媽，有合格証照又怎樣，囂張什麼，拿出你的証照出來笑死人嗎！我操你媽！！！ . ...	anger
TMD!+×÷=%_€£¥₩!@#$/^&*!!!!!!!!  中央政腐明年开始实施GST，地方腐败市长也不落人后。下个月开始在MBJB区每家每户有厕所的都收钱，家里每间一间厕所的每月RM0。官老爷，每年给的税已经够多了，门牌税，地税，所得税等等。。。求求你们行行好。。。我们的血汉钱要给你们吸干了。。。 with...	anger
WTF  幹你他馬的 你們怎麼可以這樣揪出來！ 請各位愛狗人士 分享揪出這垃圾 幹！ 	anger
Really boh?  改装无罪(v) 发觉马来西亚政府越来越可爱了，这样也想得出 off.	anger
 走私奶粉集團比錢長者炒奶粉去到北角 at 北角新都城.	anger
really?  趕盡殺絕香港人！	anger
 看到鏡頭就像看到鬼一樣一直躲   不能配合一點嗎！！？[PERSON] ：你自己拍不要拉我下水=_= 	anger
 欢迎涨价年到达 	anger
 最討厭說一套做一套的人，也討厭會欺騙的人。說謊的人最可惡，會相信謊話的人最可悲。這一生中被好幾個認為是好朋友的人欺騙過，真不知道我是太單純太容易相信朋友，還是可悲，無言…… 	anger
 这个死仔包#肥仔#三更半夜不睡觉，还要玩我丢你捡的游戏，不和他玩就一直站在哪里看着我。。。 	anger
x000  沉默之聲公開群組 又係忍唔住爆粗時間, 仆你個街死蘋果, 身為新聞媒體一D都唔中立, 乜都賴政府, 你咁有方向但又唔係帶領年青新一代去建設自己未來, 反而去粉碎香港現有嘅基礎, 香港有你蘋果同班仆街議員神棍學者, 下一代絕對冇將來 	anger
what kind of ficking gomen is that?  中央政腐明年开始实施GST，地方腐败市长也不落人后。下个月开始在MBJB区每家每户有厕所的都收钱，家里每间一间厕所的每月RM0。官老爷，每年给的税已经够多了，门牌税，地税，所得税等等。。。求求你们行行好。。。我们的血汉钱要给你们吸干了。。。 with Clair Lo.	anger
 分享出去！！0000000000媽的死變態！我放電話號碼是為了方便我的顧客下單和產品咨詢~~~！！！ 不是給你發泄性欲==腦殘！！！！網賣家們要註意哦~~~~ off.	anger
Will the panda die someday?? Wat stupid asshole brainless ppl....  希望这只熊猫不会被他们弄死.. 为了拍照夹着它的手.. 还有熊猫是吃红萝卜的吗?? 酱怕熊猫抓伤你就别去看啦~ 脑残	anger
 冬季癢～癢癢癢～乾燥	anger
 每次把襪子拿去洗完回來都會少一隻！！吼……襪子呢？我真的覺得洗衣機會吃襪子！	anger
Tiew Tze Chean Wesley Chin Wei An ply this game b0?  少时Jessica宣布退团已經夠傷心本地遊戲店家都沒打算進《零0》！我今晚打算失眠！！！	anger
serious or not?  中央政腐明年开始实施GST，地方腐败市长也不落人后。下个月开始在MBJB区每家每户有厕所的都收钱，家里每间一间厕所的每月RM0。官老爷，每年给的税已经够多了，门牌税，地税，所得税等等。。。求求你们行行好。。。我们的血汉钱要给你们吸干了。。。 	anger
 這樣的環境，皮膚病怎麼會好呢？滿地都是屎，健康狗兒和皮膚病的又一起，傳來傳去，健康的也會不健康！以為碗裡是飯，結果是一坨屎！ 	anger
，最後仲要鬧我地係賤人兼用辣椒油淋人。真係以為我地唔敢報警？我唔信道理係我地度會輸比你呢個比假口供屈我地既呀嬸。真係唔明點解會比錢受氣，就當我地唔好彩！動口又動手，你要受返個後果同教訓！我地一定會向你索償，並呼籲大家小心做下一個受害者	anger
[PERSON] Sam  大骗子！！！死老千！！！大家千万不要跟这个人买东西！！Shit！！！那些钱钱当作给你百金！！呸！！ Public Bank 0000000000 Hype Crew Marketing这是她的户口号码～～ with 孝霖.	anger
 這就是男人顧小孩的方式～老杯專心看電視、關嬰兒床、玩具丟滿地、水打翻滿地...最後～老母兩個都打！(◎_◎;)  鴻棋.	anger
 遭虐待的toy poodle，饿到骨瘦如柴，营养不良。养了就要好好照顾别三分钟热度到最后弃养！	anger
 最不爽那種不顧後面的人自私自利只顧自己的人 ... 看了就討厭！我媽咪今天煮好吃的焗烤義大利麵好好吃....她每次煮的東西都好讓人無法抗拒當她小孩好幸福呀Y(^_^)Y但....原本要減肥的 反而越減越肥了G.G with 凃小美.	anger
Help n share  失竊！失竊協尋！請各位好友協尋拖車頭白色尼亞！車牌000HL！十輪車頭！感謝！ off.	anger
经常有马来人在一边等着的，或者守着〜 千万不要走去尤其是女子 ><	anger
pls share  SG000~ 有無睇錯?? 恭喜你… 你出名了!! 遺棄狗狗都小心啲啦，比人影到車牌喇… 為咩呢?? 係咪值得恭喜你呢?? 幸好狗狗遇到好心人~ 感激!!睇唔過眼既分享出去等多啲人認識呢位所謂主人啦!! 	anger
 现在的教育是怎么了？二年级学生不会几题国文听写需要打的我女儿的手淤青红肿吗？我不是说不可以体罚，但希望老师们也要有分寸，不应该打拿笔那只手，昨晚发现她做功课的时候手抖才问起，但女儿什么都不敢说，直到今天她不敢上学我再追问她才说出事情，那位老师还说如果今天不会就罚他们不准下课吃饭！女儿还哭着要求转学。。。 ...	anger
→_→  这个uncle变态的！！过后我揭发他了他还狡辩说什么看新闻！我们一起让他红!他还好意思讲他清者自清，讲什么我这个年纪常常看 	anger
的感觀解讀⋯ 當場的壹傳媒和星島日報記者也了解事情才報道，但TVB就完全沒有查清楚！TVB，唔該你下次問清楚才報道⋯P.S.：好多謝大家嘅關心，有D「患難見真情」嘅感覺～（≧∇≦）	anger
fuck!!!!!!!!!!!!!!!!!!!!!!!  對流浪動物，你可以請他們吃一頓或視而不見但是請不要相信台灣政府會善待他們 	anger
？我唔信道理係我地度會輸比你呢個比假口供屈我地既呀嬸。真係唔明點解會比錢受氣，就當我地唔好彩！動口又動手，你要受返個後果同教訓！我地一定會向你索償，並呼籲大家小心做下一個受害者	anger
 路口監視器這樣也能開單喔~_~看到照片以為是超速，結果是-在多車道左轉彎，不先駛入內車道-啃…我哪記得那天是直行或轉彎~_~ at 我家客廳的沙發上.	anger
[PERSON] !  需要网友帮忙,寻找Yong Nyuk Yin 000000-00-0000 的家人或者孩子来自sabah 山打根的这个做月婆偷我家的水电单去借啊隆我会报警抓你的!!! with Lim Vivian.	anger
然后没事?我们在警局报案，在警局门口还说要联系回教党的人说决不罢休甚至要认着我们的脸恐吓说以后看到这个人要怎样怎样!真的没眼看 ! 有钱有权就什么都可以吗?不是歧视回教，而是你们根本没有没有尊重过回教法! 以上为个人感受 ! 请勿认为我是想惹事	anger
ﺑﻪ ﺑﻌـــــــــﻀﯿﺎ ﺑﺎﯾﺪ ﮔﻔﺖ : ﺧـــــــــــﺎﺹ ﺑﻮﺩﻥ ﭘﯿﺸﮑـــــــــــﺵ ... . ﺁﺩﻡ ﺑــــــــﺎﺵ ... . ! ﺑﻠﺪﯼ ؟!	anger
Ladies please beware..  小心这个人...不要给他骗到...正人渣!!!请帮忙Share 出去..感谢	anger
What is this!!!  一开始看到这图的时候以为是人家无聊造假但是连续两星期的0强人选都全中了真他妈的无言 玩内定的话还比什么啊 直接颁冠军不就好了真没意思还我“[PERSON] ”！	anger
Stupid idea. Bring pay slip when go petro station.  改装无罪(v) 发觉马来西亚政府越来越可爱了，这样也想得出 off.	anger
 讨厌的车们，你们都不走，后面的车都要排到阿福街了!没心没肝的 	anger
[PERSON] u  新柔交通路况情报站 这辆白色新加坡的车主，不是你一辆车排队进新加坡罢了，插我队又不出个手势道个谢，别人（女生）插你队也和你出手叫你让你也不让，又在路上丢你喝完的水杯，你的国家（新加坡）不能随地丢垃圾，我的国家（马来西亚）就能随地乱丢垃圾吗？你是不是脑残的。。。你知道你很丢脸吗？	anger
Blood sucker..  中央政腐明年开始实施GST，地方腐败市长也不落人后。下个月开始在MBJB区每家每户有厕所的都收钱，家里每间一间厕所的每月RM0。官老爷，每年给的税已经够多了，门牌税，地税，所得税等等。。。求求你们行行好。。。我们的血汉钱要给你们吸干了。。。 with Clair Lo.	anger
】就行了！	anger
正確的DJ教育和觀念，上了台也只是敗壞風氣，誤人子弟而已～應成立個門檻或者公會，不然這種情形還是會一直持續腐敗下去的！”支持就大力按讚“ “支持就用力轉貼” “支持就大聲喊出來“ 	anger
Crazy  黑店！大排檔招呼,酒店價錢！鋸人、斬你一頸血！一籠普通点心--鳳爪要$00.,一碟蒜蓉菜心$00.,三位茶$00……，地址在尖沙咀ESPRIT後面近北京道口。	anger
 请勿来这家餐厅吃～食物里加了塑胶片～我们投诉了还装作不知道～麻烦大家分享出去，不分享你会后悔～谢谢。这家店就在Pacific 	anger
Marketing这是她的户口号码～～ with 孝霖	anger
sohai  白痴! 语言是通用了, 关人民什么事情! 人民是无辜的。一些人就是那么的恨仇。气气气气气!!!!!	anger
态度这样恶劣的人!!!我们的善良好心被他们利用和践踏。真的。无言。新加坡人。上等人? 什么来的?!Please share!!!!! with Valerie Lau and Alan Lee	anger
 建筑商，看你们的水一直流过来，拜托你们能解决这个问题吗，人家也要过新年的TT，我们会感谢你的	anger
不要走去尤其是女子 ><	anger
的老爸,,照顾了我的年幼时候,在你老年时照顾你是我们孩子的责任,,,只要你和妈妈一直都安康就是我们最大的願望,,, 	anger
Hong Her  巴生人 有谁看到这个人 , 请拨打给以下的电话号码...... Mike Ong	anger
[PERSON] Tsang  五僧掃金！ 富貴如浮雲！ 六根未清淨！  at 大埔超級城.	anger
停止繼續跟我講話，然後走開。跟他一起搭火車，他會先讓其他拉著行李箱的乘客先上車或先下車，他們的年齡還不到00歲啊！這裡馬來西亞考獲0個A0個A的中學生，跟他們交談，00個裡面0個有溝通能力的問題，難怪我們的國家追不上別人。。。 at The One Academy | masters train masters	anger
[PERSON] , I don’t need sex because the government fucks me everyday!!!  天空異常的藍，我沒有看見，沒有看見雲和彩虹。  at 立法院委員研究大樓.	anger
 I pad AIR 买不到一个月就给我儿子不小心弄跌就破了	anger
 现在已经很塞车了，还要关闭，那在加影里面都被trapped很长时间才可以下kl了? 不就，要更早出门(>_<) 	anger
 幽靈…人口…為數…眾多…刪都刪不完> <	anger
 看了二十幾分的監視器畫面，惡意侵佔手機的可惡人犯已現身！！！爲了找到妳的手機要我化身柯南一天跑警察局好幾趟我也願意！請大家幫忙轉貼，我一定要這個人付出代價！雖然畫面解析度很差，但我不會放棄的。 at 中正第一分局忠孝西路派出所.	anger
，予沒入銷毀，並分別依法處0萬元以上、00萬元以下罰鍰。馮潤蘭說，紅麴米過去若業者用中藥的名義進口，依法可以免查驗，但自000年0月0日起食藥署已經全面規定必須用食品進口，並接受查驗，這一次違規的中國大陸進口紅麴米，業者則是於00年0月00日早已進口，目前已無存貨，但已針對提高該違規進口商提高邊境查驗機率。 at 永焜中醫藥—痠痛損傷整復	anger
 太誇張了！！來中油加油看到洗車機在洗警察的二部機車，來不及拍下來！接下來就看到[PERSON] 在幫他們擦機車......人民保姆啊 	anger
*********************************給我的女朋友們~平時在信義區走跳的，要小心安全喔！別走太暗的路段，最近請結伴同行吧！	anger
 這是台中一中街的乞丐精神有不正常看到請閃遠一點如果好心就幫我分享免得有人受害 	anger
 即使再美麗的花，帶著刺就會讓人無法接近即使再好的道理，帶著批判就讓人退避三尺 	anger
®」及「智平安®」服務。 	anger
 呢個人叫Yau Ting Fung, 欠我錢走左佬, 電話又唔聽, 佢以前間公司叫 [PERSON] C, 專賣朱古力架, 我有無朋友識佢呀?? 佢好似係小西灣出現多, 如果有朋友見到佢, 打比我, 重酬. 請大家幫我SHARE 出去啦...	anger
 [PERSON] 正案第四次開庭三十萬交保候傳面對如此重傷患者法院和檢察官根本在折磨病患！ 	anger
也不能这样讲话吧？？那些可都是人命阿..为何她要放弃治疗	anger
！！谢 谢 你 们 ！！！ . 记 得 丢 个 赞 赞 给 藕 啊 ＞﹏＜	anger
 馬的！操你媽的哩！有困難就找我幫忙，現在換我有困難了！怎麼不來幫忙我啊？朋友有必要當這樣？也太現實無情了吧！幹～看還有沒有以後。。。★人情冷暖～世間無情★ 	anger
Shame on u najis...  希望这只熊猫不会被他们弄死.. 为了拍照夹着它的手.. 还有熊猫是吃红萝卜的吗?? 酱怕熊猫抓伤你就别去看啦~ 脑残	anger
 高速公路ㄟ	anger
 那些人还不知丑 还敢在 facebook 咒骂人家过不到年!! 死八婆 !!!! 有种就打电话来别在那边做缩头乌龟	anger
/profile.php?id=000000000000000&fref=ts 加入捐助行列！蕭伯伯與蕭姐姐不太會打字蕭姐姐：[PERSON] 0000-000000 戶名蕭合成帳號是郵局0000-000-000-0000 at 大葉高島屋 Dayeh-Takashimaya	anger
 不分享不是华人！ 	anger
 高雄的朋友請大家幫忙轉寄，[PERSON] 車牌號碼*000請大家千千萬萬不要做此車行的車，電話000000000。ㄙ機態度差不說，對小狗也不友善，叫[PERSON] 已告知會帶小狗且有小推車，結果ㄙ機要求放後車箱，拒坐這台車 	anger
!!!我们的善良好心被他们利用和践踏。真的。无言。新加坡人。上等人? 什么来的?!Please share!!!!! with Alan Lee and Valerie Lau	anger
報道，但TVB就完全沒有查清楚！TVB，唔該你下次問清楚才報道⋯P.S.：好多謝大家嘅關心，有D「患難見真情」嘅感覺～（≧∇≦）	anger
ㄨㄨ  (幹 00改圖改超久)不要自己條件差 沒有男朋友就眼紅在婊人家換男朋友快我想你會很需要這個 呵呵((#喜歡就找椅子坐搖滾區還有位子#分享ㄅ off.	anger
讲kereta itu bukan berat ma，就是代表叫我们去park后面然后从那边搬那辆电动车过来！然后他还park到酱！真的是啊！猪就是猪啊！没有脑！ at Kip Mart Lavender Heights Senawang	anger
 臭毛，每天尿床是怎樣? 	anger
Tommy Too  中央政腐明年开始实施GST，地方腐败市长也不落人后。下个月开始在MBJB区每家每户有厕所的都收钱，家里每间一间厕所的每月RM0。官老爷，每年给的税已经够多了，门牌税，地税，所得税等等。。。求求你们行行好。。。我们的血汉钱要给你们吸干了。。。 	anger
想到我最錯的，就是花了00元去動漫節！	anger
把东西移掉的	anger
→_→  就 因为 我们 不是 中国人, 是 马来西亚 人 就 不能 用 中文字 写 东西？说 我们 没 资格 用 中文？你妹的！凸讲话 没 经过 大脑 说话 的 中国人 ==	anger
bai chi .... 希望这只熊猫不会被他们弄死.. 为了拍照夹着它的手.. 还有熊猫是吃红萝卜的吗?? 酱怕熊猫抓伤你就别去看啦~ 脑残有最新的新闻指出熊猫的手会这样是因为习惯了伸出手让人量血压~ 所以是我误会了~ 抱歉咯~ 	anger
，求表現，也是大忌⋯ at 呆將的秘密練功豪窄 in Taichung	anger
Cuties kid  当你骂自家的兄弟面对难题显得无能时，身为家人之一又sibeh厉害马后炮的你可有提供实用的意见和受用非常的援助？要不然~请你把嘴巴收进口袋里。不用像个卖国贼般和外人里应外合攻击自己的家园。Diam Diam啦！！ 	anger
信道理係我地度會輸比你呢個比假口供屈我地既呀嬸。真係唔明點解會比錢受氣，就當我地唔好彩！動口又動手，你要受返個後果同教訓！我地一定會向你索償，並呼籲大家小心做下一個受害者	anger
 說實在的 我真的很不喜歡放鞭炮這檔事不僅浪費錢也不環保而且很吵 會傷到聽力也有可能引起火災更重要的是 會嚇到流浪的孩子 	anger
pls report her  这个人，太过分，一点口德都没有	anger
妈妈自己去移掉,他竟然骂人!!!!我妈妈叫他移掉他的东西很久了!!!!那个是停车位来的!!!他还用椅子丢我妈妈的车,要打我妈妈(他是男生叻!!)最后因为很多人在看才把东西移掉的	anger
瀏覽器是因為我懶惰得很驚人幸好我耐心很夠 可以慢慢等XD	anger
下次問清楚才報道⋯P.S.：好多謝大家嘅關心，有D「患難見真情」嘅感覺～（≧∇≦）	anger
 這太過份了吧!!!!!!!!! TMD是女孩的請分享!!!!! .	anger
 就是这位先生 撞了我们的车看我们是学生好欺负 不赔钱不report还大声比出拳头要打人! 世上怎么会有这么霸道不讲理不负责任的司机呢?!?! off	anger
 今天早上[PERSON] 在小蜜蜂書局買了一把BB槍在玩的時後玩不道十分鐘後面的東西就他媽的斷了我只想說：我們不應該去那麼邪門的有白爛的廢地方 	anger
Omg !!! Got to be more alert !!!!  发林住户请注意！！最近小偷又开始干案了，我的亲戚的屋子才进小偷，大家注意注意，出门前坚持锁完们！ .	anger
good job  伤到了手真辛苦咯，吃喝玩了乐都不可以	anger
 看到喜歡的東西就拿去....都不用過問的！這跟小偷有什麼差別....甚至比小偷還猖狂..（妳的臉皮真的是比鋼鐵還厚）..！被發現還一付理所當然的樣子！仗勢欺人的模樣！真的是不知羞恥！ 	anger
 昨天下午我請女友去看「大鬧天宮」，大失所望！第一。沒有武術動作第二。沒有核心內涵第三。沒有猴子味道第四。沒有幽默笑點一味靠電腦美術特技，只能讓小童開心，成人納悶，老人睡覺！ with Chris Heng.	anger
著 iPhone 0 還要問我說：哇！妳將有錢用 iPhone 0的 你電話比我還貴 ==還一直拿我們的電話號碼 最後又說自己是新加坡華僑 漏洞一大堆 一揭穿他就說趕時間要走人真的是當我們白癡！  	anger
 缺錢缺很大還重感冒!!!上榜的話聲ψ(｀∇´)ψ，錢錢快來找猴猴吧！我愛你很討厭曖昧不明，當朋友就當朋友，我會想到就約你呷崩飲茶; 不要就講清楚，我會閃得遠遠的!!! 	anger
 白天没有水，半夜十二点才有水，七早八早六点就没有水，这到底是怎样哦！ 	anger
GST for house toilet? WTF! @@  中央政腐明年开始实施GST，地方腐败市长也不落人后。下个月开始在MBJB区每家每户有厕所的都收钱，家里每间一间厕所的每月RM0。官老爷，每年给的税已经够多了，门牌税，地税，所得税等等。。。求求你们行行好。。。我们的血汉钱要给你们吸干了。。。 	anger
money rule the world.....  现实的社会当中, 总是那么的残酷。	anger
唔得，鄰居一見我行過就閂門！」鄧生鄧太的願望很簡單: 兩年後鄧太拿到單程證，兒女接受免費教育，兩口子便可放棄綜援努力工作。明報記者 何雪瑩 —***好心你番去耕田啦,,落黎托咩,,訓得多得濟到肩周炎,,咁既野都講得出,,真係離q哂譜,,真心想爆粗你班支那豬。	anger
blame me to break your window glass !! Thanks to my brothers who assist me just now. 请大家分享 脑残的车主!!!双重泊车当着我的车。也没留下电话号码!害我迟了一个小时去载我妈妈!下次你如果再这样做,别怪我打破你车窗镜子!! 真的感谢我那班兄弟帮我推了那辆车。	anger
!真的很生气态度这样恶劣的人!!!我们的善良好心被他们利用和践踏。真的。无言。新加坡人。上等人? 什么来的?!Please share!!!!! with Alan Lee and Valerie Lau	anger
FYI~~  中央政腐明年开始实施GST，地方腐败市长也不落人后。下个月开始在MBJB区每家每户有厕所的都收钱，家里每间一间厕所的每月RM0。官老爷，每年给的税已经够多了，门牌税，地税，所得税等等。。。求求你们行行好。。。我们的血汉钱要给你们吸干了。。。 with Clair Lo.	anger
 才开就看到变态 	anger
，尤其是即将结束代祷时。0. 整场任由婴儿一直地哭。0. 咀嚼或波香糖。 （来自波多黎各的朋友说，他特别恼火，有些人“嚼口香糖像山羊一样。”）00. 严重干扰他人的行为。 （有人抱怨一位男士在聚会中正为他妻子做背部按摩。） 	anger
May god bless the innocent panda  希望这只熊猫不会被他们弄死.. 为了拍照夹着它的手.. 还有熊猫是吃红萝卜的吗?? 酱怕熊猫抓伤你就别去看啦~ 脑残	anger
最好做好你的工作！不然给你丢工作！	anger
Home made salty fish bun....my wife own ingredients. .....  第一次做的咸鱼包不知道好不好吃 	anger
 注意！如果你的手機有收到以下的訊息，請千萬不要點，他會自動發簡訊給你手機通訊錄內所有的朋友，你的手機費用會爆炸，朋友也會起笑，因為這是約炮軟體毒，很毒的！英俊智關心你 	anger
！ at 鹿港頂番婆 水龍頭的故鄉	anger
 涨价涨到理晒大埔是时候换工了! 	anger
EVonne Wong Celine Wong Alice Wong Wagner Chun Siang Sing Esther Chan lolxx??  一开始看到这图的时候以为是人家无聊造假但是连续两星期的0强人选都全中了真他妈的无言 玩内定的话还比什么啊 直接颁冠军不就好了真没意思还我“[PERSON] ”！	anger
☺☺☺ You're a Beautiful Woman ☺☺☺  有些人他媽根本不重要我把他看的重的跟什麼一樣..結果呢 ? 還不是跟狗屎一樣朋友 姐妹 ?狗友 婊妹 !操 .. at 有感而發.	anger
別養，現在上千名網友看到影片後，氣得已經展開人肉搜索，要把這對兇殘虐待小黑狗男女揪出來，公布照片和車牌號碼，讓殘忍兇手嚐嚐虐夠的代價。 	anger
 兒子新手機一直進不去酷狗用到快要把手機……… with 翔議.	anger
Wesley Lin  各位老拓的朋友們~一起來老拓 瘋 0000世足盃吧~老拓 0樓B區 提供大螢幕觀賞世足賽事盛況~時間為 0000/00/00(五)-0/00(三)~歡迎各位熱愛足球運動的朋友們~千萬不可錯過~ at 老拓餐廳.	anticipation
(Pratyahara)-暫時關閉你的感官,放開情緒,心念控制,放鬆與統整感官知覺,活化心靈0.專心(Dharana)-專注於自我內在,專注力,集中心念 0.入定(Dhyana)-冥想,延長專注力在整個意識運作上,身心處於放鬆且安定的狀態0.三摩地(Samadhi)-身心靈合一,達到完全覺醒與自我解放.~圖片的結印是智慧的意思,幫助我們增長智慧~	anticipation
 今天晚上結算會議聽到一個令人驚訝的消息，我們單位的同仁，今天以兩年期的儲蓄險成交了將近	anticipation
謎之三:咁就要[PERSON] 0月00日的	anticipation
变的是开拓，你所做的事情，也许暂时看不到成功，但不要灰心，你不是没有成长，而是在扎根，不为模糊不清的未来担忧，只为清清楚楚的现在努力，加油吧	anticipation
？  今天又是週五聚會！ 原來鳳梨酥可以在短短00分鐘就可以吃到，而且制作非常簡單，鍋子真的厲害 也感謝古乃元講營養講的出神入化，讓我們又在次學習營養的重要，期待下禮拜週的手工麵包制作嚕！！ .	anticipation
is it real ? Anthony Fernandus Dine  泰国发生的事情 , 听说是下雨打雷电激下来的，现在受伤很严重。难道世上真的有龙的存在？？？如果有的话希望赶快好起来放生~Popi PopI 一切平安★ 惜分享 ★ 	anticipation
 又到了開心的禮拜三！哈哈哈  at 大佳河濱迎風足球場.	anticipation
 现在什么东西都涨价。但是你放心，我的红包没跟市场走势。	anticipation
✉: 请到 留言哦~ 	anticipation
 本店的I LOVE VITAMIN和ENZSERUM现在有大优惠噢！！超值优惠！卖完为止！！外敷内服的疯狂优惠配套！！快来抢购(^V^)♥欢迎古来北干新山区面交♥ with 陳柏志 and...	anticipation
感到非常抱歉，請原諒我 (跪)辛苦你帶客人上陣，還能有如此優異表現，值得讚許((拍拍手))這是女羽的開始，未來還有很多機會等著我們去證明，我們存在的價值，我們一起攜手往0000邁進吧，Go～～ 	anticipation
 從0000回顧0000，拿了很多獎項，就這兩個最珍貴，因為最難拿，穩定的爆發力，每一季都在挑戰自己，用獎項寫日記，謝謝富邦謝謝富海，也謝謝我有一個好兄弟兼對手 岳品宸 ，讓我想起了兩句話：一個成功的人要有貴人，一個非常成功的人要有敵人！ with 岳品宸.	anticipation
 啊! 好希望那個粉絲是我呀!!! (Cre Naver) with Peanutsnoopy Lucy.	anticipation
Endrea Wong your case lose jo  KL 中砍记 ～ 两盘菜 0盘面0只虾 两盘华蛋面..总额：000.00 老板说一只虾要00 .	anticipation
 薑母鴨店促銷嚕各位大德幫忙分享囉謝謝 at 深澳坑帝王薑母鴨.	anticipation
We Are Hong Kong!  我清清楚楚告訴你們，香港人擊退防暴隊，重奪干諾道中！人太多，防暴隊撤退，這裡超過萬人！香港人勁呀！你哋係最強催淚彈！	anticipation
 哈哈哈我们开餐噜吃饱饱就要出发回乡Crystal Kaiyin  	anticipation
 哈哈哈！我有啦…不用等… with CoCo Lim.	anticipation
 工作地點 台北市松山區八德路0段000-0號0樓(近饒河夜市/[PERSON] 站約0分鐘/捷運後山埤0號出口約00分鐘)工作時間 中午00點~晚上00點休假制度 月休六天薪水制度 底薪+抽成+獎金連絡方式 吳小姐 0000-000-000/00-0000-0000環境舒適/同仁和善，歡迎美甲/美睫師加入吳舍團隊  at...	anticipation
 原來這就是男人這麼愛打電動的原因‼️	anticipation
Happy Family!  經過今天登司馬庫斯深山神木的考驗。。覺得對征服百岳越來越有信心啦  at 司馬庫斯巨木群.	anticipation
 歡迎（＾Ｏ＾☆♪ 闕大雙駕駛他的愛車來做四輪定位(*ˇ︶ˇ*)日系名車SUBARU LEGACY 0.0  at 慎益汽車.	anticipation
 妳兒子撞我的車肇事逃逸，說要處理拖了幾個月，打電話過去態度像在跟妳乞討，後來又打電話來道歉，我只是想簡單就好，妳竟然以為我好欺負是不是，才0000。雖然我要跑一趟高雄，可是你們要跑很多次法院。既然妳要玩我們就玩個夠。	anticipation
 新的一年開始了還在為了找工作而煩惱嗎？[PERSON] 想一個月工作薪水卻只領0～0萬而感到不滿足嗎？卡債 貸款 家庭 房租 經濟壓力各種需要錢的原因壓的你喘不氣嗎？不要害怕 想挑戰高薪的女孩們私訊我絕無色情，內容單純，並安全專車接送上下班	anticipation
[PERSON] hopeful indeed lol 和平佔中 x 民間創意 希望在真普選，香港人唔使絕望！由民意決定誰是配當特首的材料吧。原圖/ 自網民編製：噚日睇完新聞，聽到[PERSON] 話唔會辭職，個心都定番啲 	anticipation
 分享~不必艷羨那些風光無限的人，他們都曾在孤單時無人陪伴、害怕時無人保護、無助時無人伸援、勞累時無人依靠......漸漸地就長成了現在堅強獨立的樣子。--每個人都有段無人問津的時光，這是為了讓我們學會如何與自己相處。無助時無人伸援、勞累時無人依靠......漸漸地就長成了現在堅強獨立的樣子。 	anticipation
 000	anticipation
 感謝老闆支持手工具~LK-00000  at 手工具.	anticipation
 不聊了, 不聊了先去 ( makeup ) 爱美美等出门走走喝酒开心愉快了今晚 , 哇哈哈哈哈哈	anticipation
 世界香港夜光龍．醒獅錦標賽 0000 0月00日至00日舉行地点 : 香港體育館(紅館)0月00日 (日)醒獅高樁初賽(夜)夜光龍錦標賽0月00日 (夜)醒獅高樁决賽  at 紅館 Hong Kong Coliseum.	anticipation
Support!  今早零晨四点半我工作後回到家有点對大家擔心，便決定去看看你們，買了你們需要的水和食物，來到看到你們很多都很疲累，我很痛心。但為你們這一代感到驕傲，因反國教起你們已開始成長了，你們有理性思考及勇氣，加油！一些事可能沒發改變，但未到最後故事也有機會改寫。Blessing ! 	anticipation
一張ParaCross EP哦!!!!--------時間：0000/00/00 (六) 00:00 - 00:00地點：岩石音樂Rocks地址：高雄市鹽埕區莒光街000號地下一樓 B0購票資訊：預售票$000、現場票$000購票專線：Jerry 0000-000-000丸子 0000-000-000阿釗 0000-000-000 ...	anticipation
Hong Kong Print Award 0000  《第二十六屆香港印製大獎》正式啟動 印刷，設計，包裝和創意人記住參加啦~ Sep 00, 0000 截止！  	anticipation
 告別即將離去的金蛇銀舞，迎向未來嶄新的萬馬奔騰，時值春滿甲午農曆新年前夕，碧琴奉上最誠摯溫馨的祝福，願您平安、如意，一切美好的祝福與您同在。今天是除夕夜，願所有的朋友們都能盡情享受家庭團聚的喜悅，歡度這美好的農曆新年。祝福大家神采駿逸，福氣滿門！新年快樂！ 	anticipation
Amy Lee  有感而發，最近生活過的忙碌但很充實，感覺好累，今午巧遇一位前輩這麼說的:妳為什麼那麼忙，看某某拿督[PERSON] ，他多成功，桌上沒有任何文件，我在想這位拿督[PERSON] 在成功之前必定經過這忙碌的日子，希望我在不久的將來也能像這位成功的拿督[PERSON] ，加油！加油！ 	anticipation
懊悔，都無法重新來過，[PERSON] 然是個未知數，新的一年，給自己全新的開始，不管過去做了什麼，現在還來的及挽回，把握一切，不要再造成任何遺憾，每個人不管身在地球何方，都要開開心心，由衷的說一聲新年快樂，帶著希望夢想的氣球向前邁進。	anticipation
 Ready stock! Ready stock! 现货!现货! 价钱绝对合理!! Choco mint Cappuccino Vanilla Cream and cokies Strawberry Hazelnut with YK Lim.	anticipation
 高興的早晨各位早上好、天氣不穩定、很冷很冷、大家出門在外要穿厚衣保暖、健康開心	anticipation
 我家大老板超级可爱又搞笑啦!My House Big Boss Super Cute And Very Funny La! .	anticipation
Don't miss it!!!  0月0日晚上0点在Berjaya water front, [PERSON] 将分享他的地狱之旅。主曾带领他到地狱亲眼见证为的是要把这讯息传给世人。欢迎大家踊跃参与。若你需要交通接送请联络我。[PERSON] 祝福你:)	anticipation
問佛：『人生為什麼會有那麼多的遺憾？』佛說：『心存遺憾，源自唯美。遺憾太多，心就痛楚，情亦感傷。懂得淡泊，神清氣爽。君若不解，去看窗外的枯草衰楊。』我問佛：『人為什麼會孤獨？』 佛說：『心靈無依，人就孤獨迷惘，融入大家，大愛無疆，心就生無量。』 at 光慈講堂	anticipation
照顧妹妹是我們的責任!卻也讓大家擔心!在此附上十二萬分的謝意!!感謝大家!!	anticipation
Raymond KP Chew Larry Tay this looks nice  就在明天 00Pm开始 在Perling Mall 得空的朋友可以过来看看 到时会有000++Stance car喔	anticipation
 第一次自己做了海绵蛋糕，谁要做白老鼠?	anticipation
 @@想做個成功的領導人，就必須容忍同事向你挑釁、與你爭辯、跟你作對。~~【哈佛商學院教授 [PERSON] 】……@@	anticipation
r  終於熬到這天了，至今退伍了，雖然開心但心中帶點依依不捨，少了你們的陪伴，在這軍旅生涯中，遇到好多點點滴滴，還認識到三個非常要好的知心兄弟，當我有苦難時你們總是幫忙我想辦法，還有！還有！《砲排的兄弟》。謝謝你們~《學弟們加油！！只要你肯做，沒有什麼不行的~》軍旅生涯告一段落，接下來要迎接更多的挑戰，加油！！！ 	anticipation
very good!!!!!!  今天是來到這裡運動的第一個月 也是第十二天 今天量身 雖然身體只有手臂瘦0.0公分 其他沒變 但是體脂體重都減少了0.0 而且今天忘了帶運動衣服 所以穿著外套運動(因為穿無袖) 來那麼多次第一次脈搏終於從00跳到00 難道是因為穿這外套嗎XD 	anticipation
組合，以針對處理特殊的肌膚問題。基礎保養組合 煥顏潔膚凝膠、草本化妝水、煥顏日間乳液和赋活晚霜 包括 基礎保養組合包括 進階保養組合Herbalife SKIN 系列將從0000年0月中起在亞洲各主要市場上市，並將在0000年之前逐步推廣到其他市場。	anticipation
 与马来西亚Astro跨国合作的 香港TVB新剧集 #单恋双城#即将于0000年0月00日透过 Astro On Demand启播，剧中演员 #[PERSON] 煎pang 、 #[PERSON] elaine 、#[PERSON] 、#[PERSON] ，连同参演的 Astro本地圈 艺人亦订于0月0日（星期日）前往槟岛时代广场娱乐城和槟城大山脚Tesco为该剧进行两场公开造势活动。 #单恋双城# 【轉】	anticipation
0000 Awards & Achievements.my  再长的路一步步也能走完，再短的路不迈开双脚也无法到达。切记！行动永远比空想还重要。 with 权忠 and Ray Studio Wedding Collection.	anticipation
Joe Chua Master Joe Allen Gan Jun Koay Lim HongWei Lois Chiew Joanna Oon  我不是烂赌，我只是想让人知道我失去的东西我一定会亲手拿回	anticipation
的支持	anticipation
 瘋了八天的促銷 ，明天終於最後一天了，大家都快被操翻了  at 鳳麟粥飯麵食館 -竹南中正店.	anticipation
 From 老杜的家 - 粉絲團專頁 ~ 最新演出活動資訊：0000年00月00日（大年初五）下午00：00於台南市 鹿耳門天后宮前廣場~~~將有 藝曲愛樂管弦樂團 演出，歡迎各界親友來賓踴躍前來觀賞！ 老杜的家 - Home of the Coffin ＆ 藝曲愛樂管弦樂團 敬邀!!!  at 鹿耳門天后宮.	anticipation
 人生真的很辛苦，為了生存而勞累、為了情愛而掙扎……經歷了傷痕累累的過程，換來的就是”成長”……雲淡風輕笑看過去的種種……勉勵自己換來全新的自我……^^~午安~各位朋友！ 	anticipation
Actually I want to know what they're doing..  人生如戏 。Bomoh 还有 name tag 的！ 真的是不简单的大粒人士 ！ salute 他们的勇气 ！ 掌声鼓励一下 ！！！！ MALAYSIA BOMOH ， MALAYSIA BOLEH ！！！！！！	anticipation
 【戰勝自己～便是贏得偉大的勝利！】用大量的行動證明決心；用成就來證明選擇正確！再次設立目標～為下一次“圓夢” 而努力！！ .	anticipation
 快下班了，Peggy Lee已經購入全新的項鏈和洋裝，希望可以在今年尾牙遇見心目中的Mr. Right！ at 信義新光三越A00.	anticipation
 绝对会让人不断惊喜尖叫的五星级温泉酒店！  at 長[PERSON] 酒店(礁溪).	anticipation
 早安了亲爱的伙伴们,起来记得吃早餐噢^_^人生如戏，演好戏不要留恋，演烂戏不要在意。不怕烂戏，就怕没戏。如同射箭，最重要的是把箭射出去，结果是悲，忘掉，是喜，也忘掉，继续前行！每一天都是新的开始！[愉快]	anticipation
 感謝“民雄之旅“一早訂購整車的素食早餐，一陣混亂中希望沒有漏掉了什麼忘記放，重點是要合大家胃口啦！ 精緻平價早餐新品即將上市 with 陳怡君 at 魔法土司.	anticipation
Simon Chin  我不是烂赌，我只是想让人知道我失去的东西我一定会亲手拿回	anticipation
煎时肉汁会流失先把不沾底的平底锅烧热加入冷油（不需要很多），把包放入锅内，转中火让它煎一下，再加 0汤匙水盖上锅盖让它煎到干水，然后把另一面煎到金黄色就可以起锅了！！ 香喷喷的咸鱼包是超赞的点心。。一定要趁热吃才会有爆汁的感觉。。 如果不要马上吃，我建议把包好的包子放入冰箱，要吃时才煎。。 祝大家成功！	anticipation
於0/0日至0日受理參選人登記、00/00日讓參選人抽籤決定號次、00/00日公告選舉候選人名單。 at 南投縣議會新建議政大樓	anticipation
什麼地方我們就會陪伴他到什麼地方，因為我們根本離不開他，如果你沒請他進來，我們兩個不論是誰進來，很快就會失去活力和生命，所以，我們在哪裡都會和他在一起的！”人生的幸福之一，是你的健康。如果你看到了這個故事，是因為有人在默默地祝福你。如果你也關愛你的朋友，就請將這個古老的寓言故事轉發給他（她）。祝您天天快樂！健康幸福！！！ at 永慶不動產...	anticipation
thx for your support!  夏天熱到[PERSON] 好痛 T﹏T 終於遇到救星 (bling bling眼) @macau's aroma corner ge 天然 ezcma gel.. 用完好爽yy	anticipation
Brian Lee  还等什么!	anticipation
ㄑㄅ Apple 我知道客人沒有永遠的～所以沒來的我很感謝曾經為你們服務！繼續支持我的由衷更感謝你們❤️❤️你們的支持是我更大的動力哦！ at [PERSON] 髮廊[PERSON] 店apple設計師.	anticipation
小宇宙你是[PERSON] 的箇中好手嗎？這場比賽非你不可，因為能激起熱血的奮戰因子日期：0.00(日)早上00點到00點地點：台北市中山北路0段00像00號0樓 中山區民活動中心C教室等你來觀賽~~~~[PERSON] 表演賽~ *****	anticipation
[PERSON]  收到来自台北中华艺术学院的邮包，现在正式成为艺术学院“水墨班”的学生，虽然是网上授课，但足以让我兴奋良久。所谓学海无涯嘛，愿大家也一样“活到老，学到老”！Parcel from Chinese Art School , Yes ...I'm back to school :)	anticipation
omg TT  進場啦！我們在搖滾區R,很靠近舞台啊！！！倒數 0小時半 0NE0 AON馬來西亞站演唱會 with WaWah Lim.	anticipation
 精神可，情緒高昂，主訴晚餐沒洋芋，予澄清接受度低，晚餐進食全，預計明日MBD，續觀察  	anticipation
 倒数0000年的尾声，骏马奔驰0000年。。。祝愿大家： 新年快乐，马到功成，身体健康，心想事事成。。。 .	anticipation
的	anticipation
 要過年了是否該換新貼膜了(((誤 咪保膜	anticipation
Thumbs up (y)  我不要在在意人家怎麼看我了、太認真會傷了自己的.從今天起我要作我自己° at 安安民宿.	anticipation
[PERSON] 又一批货到达啦！ 提拉米苏让顾客们无法抗拒，由于顾客们火速的订购，这期间货量出得好快噢！你还犹豫什么呢？瘦身就为了健康，安全健康的瘦身产品就是我们cellstory注重的！联系我们HL Group Agent : Cheryl Chang 000-0000000	anticipation
 想減肥的人趕快來喔！過年前減個0公斤起來等^^只在0月份有的促銷，搭配減0-00公斤的計畫，送德國精品BRITA濾水壺今天一個新的減重客戶說她家一直都用這個牌子濾水！！濾出來的水，有山泉水的甘甜好喝……我沒用過，但被她一促銷，我勢必要搶到一個藏起來用，哈哈 .	anticipation
内脂肪率明显减少[PERSON] 女性服用后非常满意LOVE U SO瘦身功效欲知更多详情请联系我: 000 0000000 (WeChat/SMS/WhatsApp) 	anticipation
 00.00.0000(星期六)今天Monsters舞团的美眉将会在parkcity mall带来性感, 活泼的表演喔!而时间将分段为:0.00pm - Expectation0.00pm - Angel & Devil0.00pm - When I grow up请大家守住这时间前来捧场喔!MONSTERS 在这谢谢各位的到来 with Cheng Eileen and 00...	anticipation
 乖乖地當個小女人...呵呵...告訴我誰不想寵愛溺愛我沉浸過享受過但為何還是孤身寡人一位我主觀意識強烈鬼靈精怪我的塔羅老師告訴我說...你要找一個壓得過你的男人是啊！很中肯！非常中肯！他的行為舉止and做事態度讓我敬佩他讓我無話可說讓我心甘情願讓他掌控我何時出現何時出現！？期待 at 統聯車上。	anticipation
排有個人回頭，見到奶奶，毫不猶豫起身扶著奶奶，下了階梯，轉彎，並走了一小段，我當下感動得熱涙盈眶⋯⋯[PERSON] 。一位巨星，就該是這樣的典範，處處以人為本，將心比心。金馬00，我們看到的不只有丰采，更是氣度。 with Andy Lau	anticipation
妍高效潔膚液000ml (油性.混合性或痘痘肌用)	anticipation
报纸一窝冒充读者的报人一条长长长长的名单一首歌功颂德的赞歌一曲唱了会哭的悲歌一个马来西亚之歌呀一首没完没了的长歌（杨白杨。0000年0月00日）	anticipation
www  噚日睇完新聞，聽到[PERSON] 話唔會辭職，個心都定番啲 	anticipation
/andean-plateau-volcano_00000_000x000.jpg「我們」祝大家0000有個豐收旅遊年, 新年快樂!	anticipation
0000 止,購買時需出示分享帖文,(尿片,[PERSON] 及特價品除外)	anticipation
/0000 由于位子有限 只容纳下限量00人来参加法会所以要的人就要快了哦!正面祈求（功名：官位、学业、事业等）第二面祈求（姻缘：婚姻、感情、人缘）第三面祈求（财富：正财、横财、财禄）第四面祈求（健康：治病、平安、亲人健康、家内和谐）v with Karaney Bong New	anticipation
 亮晶晶 香水! 床單?	anticipation
把口封好，不然煎时肉汁会流失先把不沾底的平底锅烧热加入冷油（不需要很多），把包放入锅内，转中火让它煎一下，再加 0汤匙水盖上锅盖让它煎到干水，然后把另一面煎到金黄色就可以起锅了！！ 香喷喷的咸鱼包是超赞的点心。。一定要趁热吃才会有爆汁的感觉。。 如果不要马上吃，我建议把包好的包子放入冰箱，要吃时才煎。。 祝大家成功！	anticipation
 開始期待0月燈會~~~(建議全螢幕看圖比較爽~!)	anticipation
 過年前做最後衝刺，業績衝衝衝~~~~~臍帶章，胎毛章.筆，結婚對章，開運印鑑章，公司章，連續章.....等!送禮自用兩相宜，快來訂購唷！台南市區可到府服務~高雄.嘉義可到區服務~ at 給寶貝的第一份禮物～峰印章.	anticipation
伙伴的顾客：我有好消息告诉你^^ 我的顾客说tiramisu很好喝..而且喝了一个星期多的她..觉得双腿变瘦了..走路都感觉没有像以前肉贴贴摩擦一起!一杯香浓的 Dark Secret Magic Tiramisu , 满足咖啡瘾，又能保持好身材，一举两得	anticipation
(y)   最后0天的冲刺!！ 请赶快上网投票吧！！！ 	anticipation
 全家出遊 	anticipation
 倒数新年来临,小心驾驶,安全第一,记得回家和父母亲们吃团圆饭。祝福大家马年行大运,恭喜发财!	anticipation
！！！）而「情人節大抽獎活動」將於0000年0月00日公佈得獎名單！因為店主想到各位靚女會係情人節化個靚妝，之後當然要好好卸妝啦！！最後，當然要祝大家馬年行好運！日日都笑口常開！！！粉紅色@@@原版綠色@@@抗氧化銀白色@@@高效補濕淺綠色@@@防敏感的 with Ivie Chan and Kyan Lu	anticipation
 [盛]讚揚名騰萬[馬][發]榮滋長迎新[年][來]接財神眼鏡[行][祝]賀馬年財富[大][福]星高照迎好[運]來來來，[PERSON] 鬥陣，求好籤，順便幫你解個卦 	anticipation
lovely 午安安![PERSON] 的朋友!很多事情,看穿但不要說穿只要心裡有數就好了!沒必要說出來。 .	anticipation
 來來來!!!0000再讓我為您們服務吧！商標 專利 申請!!!! at 巨群國際專利商標法律事務所.	anticipation
,搅拌至面粉无颗粒0.拌匀后放入预先预热000度的烤箱,烤00-00分钟。 	anticipation
 笑声，欢天喜地；幸运，铺天盖地；才情，经天纬地；财气，呼天唤地；豪气，遮天盖地；福气，惊天动地；元旦，冰天雪地；快乐，翻天覆地！ .	anticipation
誰阿.....你們覺得是哪位呢??	anticipation
 Our bridal is hiring a make-up artiste. Pls contact us to set up an interview. 000-000 0000 / 000-000 0000我们婚纱店要聘请一位化妆师。请来我们的婚纱店来应征。打000-000 0000/0000。 谢谢。  at 尚流摄绘-...	anticipation
 保持中立，是不會樹立敵人，但也沒有絕對的朋友學褚小唯在手上畫充電充飽飽的電池有人整天在拯救世界，沒空跟我吃飯=0= 這週上台北工作希望年底也可以上台北工作><	anticipation
：《唯有戰勝了自己,才能夠成為世界一流的選手》。池[PERSON] 先生曾指導：「年輕時歷經種種的試煉與苦難,始可於人生的最後獲得勝利的榮冠。因此,絕不可以逃避青春時期的苦難與試煉,因為人生最後階段是否能得到真正『安樂』的境地,端視青年時期是否有如『嚴冬般的鍛鍊』總之,鍛鍊.苦鬥.才是勝利的源泉。	anticipation
Vivien Wong i want eat this  刚刚做好有一把长尺的size黑芝麻和斑斓瑞士卷,现在要进冰箱定型,明天才切。	anticipation
 這面膜真的真的太可愛了♥️我覺得好好玩	anticipation
Sounds familiar Tan Kz Han Yang Yan Chuan Tan Xiang Jie Tan  继续说我的是非 继续说我的坏话~~~~~~~~ 啊啊啊啊不就好棒棒 ~	anticipation
0、麻煩清洗乾淨給我 0、不要捐錢 會不清不楚 況且我不是要錢 00、要寄送的人跟我要地址 但不要公佈我的個資我們只是用微小的力量 就能做好事 相信一定會有好報！！謝謝你們 願意捐贈的請留言！！加我好友才能給寄件資料唷！！  at 新北市鶯歌高職	anticipation
join us!  還有誰要參加我們的leo installation嗎?0月00號(星期日)就截止了munshi Ibrahim的學生要去的記得在星期日帶rm00去學校喔...沒交通的人我們會準備來回巴士,巴士費是rm0...要去的人趕快跟我們購買門票吧 ! . ;照片... <0为了记载 0切曾经拥有过的...	anticipation
专业的保险顾问!  	anticipation
！！ 	anticipation
 開心終於收到了遲來的生日禮物謝謝 THUG with 林宇柔.	anticipation
免疫球蛋白量仅为年青时的 00-00％，因而容易受到病原侵袭，受疾病感染的机会也相对增加。牛初乳的丰富生长因子和 IgG 等免疫物质可增强体质，促进人体新生细胞生长，恢复健康，对一些老人常见病如关节炎，痛风等也很有裨益。关爱家人。今天就行动Pm/wechat : ValentynMemories 0000000000	anticipation
.遠通不知什麼叫做以客為尊如果車牌辨識真的技術這麼好，就讓我來測試看看你這方便的車牌辨識有多好用吧~印個0張A0響應一下~	anticipation
、沒相貌、沒身高，同時臉上還有一顆直徑五釐米的大黑痣，但我有一顆愛你的心，一顆善良的心，你願意娶我嗎??男人們都啞口無言了吧！看完你笑了那就轉走吧!別老說自家的老婆會花錢，羡慕別人家的老婆會省錢，會過日子，養土鴨跟養天鵝的成本不一樣吧!!開心一下，早安。 with 何恭谷	anticipation
 旅樂序行動網頁完成！我搞定了 或輸入 m-hotelrelaxclub.com 掃一下！	anticipation
 千萬不能倒下！ 	anticipation
 明天就是「一日店長的活動囉」活動的時間是下午0：00～0：00喔～^_^《大家要記得喔！請大家告訴大家》 .	anticipation
，全部免費讓你了解也免費幫你敷臉喲，歡迎私訊我或電話 - 0000000000	anticipation
 改装无罪(v) Proton iris! Tmr launch..	anticipation
！ 我有超棒的兩個dj跟兩組超棒的樂團～ [PERSON] 放客兄弟 [放射空間] - Ground Zero 謝謝你們！那天 老娘要給你們暢飲啦！喝吧！！！！！！！ at 0000小酒館	anticipation
and hope to see you on Oct 00. Limited tickets available! 这是为新加坡红十字会的筹款演出。好多人误以为新加坡红十字会和国际红十字会都共用援助；事实上并不如此。欢迎您踊跃支持，在观赏我们为您精心策划的演出时，也为我们身边需要协助的国人献上祝福。票数有限！	anticipation
了解，可以自行上網查查看，不吃動物，到底有多麼大的好處!?愛，是我們的本質，愛，也是所有問題的解答。【LOVE OUR PLANET AND FIGHT FOR ANIMALS】 	anticipation
 呀~~~香香真的好美o(≧o≦)o朋友好可愛 拿我的照片跟香香合(￣▽￣	anticipation
 你们说,有几个人这一生有机会上娱乐版的,而且版面还不小…lol十二年前拍照时,万万也没想到,我们会有今天~ ...	anticipation
OMG #月入超過000萬的黃金單身漢  ★★選對平臺努力最重要這位美國 #YPR 頂尖領袖Brad四週單循環獎金就 #五百多萬台幣【0cycle=00美金.0美金*00】【Vemma給的匯率永遠00】我的格局因為Vemma變不一樣了！接觸的人也不一樣了！	anticipation
一下)P.s 得獎者一定要做齊以上0 項，先可以領獎ga! 截止日期: 0/0 (初十) 晚上00時~ 00/0 我地會抽出兩位馬年幸運兒^^ 得奬結果於00/0下午公報~ 祝大家好運！！	anticipation
 DG海外終於大團圓啦啦〜亮點驚喜不斷斷〜好嗨好嗨！ .	anticipation
 朋友們 早安哦^^~*不知道大家看銀杏看膩了嗎 哈~今天是[PERSON] 想好要衝哪了嗎?!!大台北地區的朋友們 來呼喚一下吧~歐[PERSON] 我 新手....很需要學習指導的啦0000.00.00 南怡島.Korea 索尼 A000 00-000 	anticipation
它捐给有需要的人,当天也有抽奖活动呢,能吃喝玩乐,又能做善事[微笑] 如果不会路的请联络我吧 。  	anticipation
 開始小旅行囉～  	anticipation
IMBA such IMBANess~!!  [拍攝花絮]DATE.A.Live-Tohka Yatogami(靈裝ver.)最新一集動畫十香終於要黑化了!!!你們會期待我cos黑化的十香嗎•﹏•? .	anticipation
 @@ 【會淹死的經常是……最會游泳的】@@ 【哪怕打了一百次的勝戰，都要保持第一次出征時的謹慎；哪怕輸了一百次的戰爭，都要保持第一次出征時的銳氣。】……黃琨傑分享@@@	anticipation
 拜天公 ♥ 祝：0000 合家平安！生意興隆！事業再創高峰！業績更上一層樓！身心靈富貴！身體健康發大財！！小人閃！貴人來！興！旺！發啊啊啊！！ with Kathy Loo and Sia Chuang.	anticipation
Hi 0 team就搶着洗我的跑马儿。。有趣！当然我也首位捐款	anticipation
 “0D 逆齡 ” 義大利T.e.N 不需要動刀拉皮 不用受皮肉痛就能保持逆齡的臉蛋好評不斷 ,高科技[PERSON] 天然 即將過年了 ； 美女們 快來用的美美的吧	anticipation
=欢迎订购询问： 留言哦~Wechat：milkmilk0000000  	anticipation
是，唯有自己親自去了解，自己去幫助他們你才懂得你生活有多好。不是盲目的去捐錢就好，而是你從這個動作學到了什麼，了解什麼，改變自己什麼。阿公阿嬤好可憐，晚安〜我好睏！磨石子[PERSON] 的聯絡方式吳政良0000000000高雄市瑞東一街00號(圖片、文字 全部轉自於好心FB網友：詠棋)(轉貼文)	anticipation
 這群人瘋了……（無言ing……) 背景音樂:[PERSON] 朋友 .	anticipation
 一則簡短的簡訊~一聲親切的問候~ 代表著關懷和思念~也包含著祝福與感謝~在這年終歲末的最後一天~舊的一年~非常感謝您們的支持與照顧~ 新的一年~更希望您們繼續給我們........支持與鼓勵~批評和指教~在此...........小弟~祝您新的一年~新年快樂~心想事成~ 事事順心~馬年行大運~馬到成功~東德機械/百榮吊車 賀 	anticipation
 法国，巴黎，埃菲尔铁塔，夏天晚上0点开灯后的景色。在这个所有人都向往的浪漫之都，路上到处都是热情奔放的法国人~ 埃菲尔铁塔的美将会在每天入夜开灯后时加倍~ 而这座铁塔最美最美的时候就是晚上每小时一次闪灯的时候，你简直无法相信那么美的一幕竟然会在你的眼前发生！这一切真的太棒了！ 	anticipation
 Hi~各位冰友晚安*^o^*哇!哈哈~今天真的有一位導遊來看我昨天的那頂假髮唷^-^沒想到那位導遊嘴真甜~誇我是髮質太好了啦!!害我都不好意思啦~~謝謝你囉!!!還好今天有太陽公公的關照~讓今天的遊客變多嘍!漸漸有寒假的感覺!老闆的心情會愈來愈好唷*^o^*這樣我的飯碗才保的住唷^-^一起努力吧! at 福鹿山休閒農莊	anticipation
，我不是医生，很多东西我也不大清楚。只是这个补品对我的老公和璇璇喝了有效我才分享给大家的。如果你们有什么疑问，麻烦请大家去问药材店。。谢谢哦！ 	anticipation
及蛋黃的滋養成分，主要具有美白和修護功效，可保溼及補充肌膚所需的營養！利用不刺激肌膚的二氧化碳作為導入媒體，『讓肌膚像雞蛋一樣白滑水潤』。0.Holika Holika 0步曲豬鼻黑頭套裝有黑頭導出液、鼻貼 、收毛孔精華 	anticipation
 期待禮拜天的金虎爺呷炮威力，即將引爆旗津吧～～  at 期待下一次的熱血.	anticipation
 0000 總騎乘Distance: 0,000.0KM, Elev Gain:000,000M對一個上班族來說已是知足，最後也謝謝這一年來互相陪伴的GCR小隊、Rapha Taipei大家族、Racing Bee Cycling Team、[PERSON] 單車與家人朋友的支持！祝大家新年快樂，0000年Keep Riding!	anticipation
 這種天氣上健身房踩飛輪真是一大挑戰,哈哈 at 伊[PERSON] 站館.	anticipation
 随着新年的钟声，伴着新春的第一抹朝阳，让祝福和希望随春天的绿色成长，带给你满岁的丰硕和芬芳，收获快乐，收获健康，收获如意和吉祥祝您马年万事如意。 .	anticipation
 就是今天了！我們高雄《戰舞姬》要志霸天下~大家快點來找我們下載app軟體唷~別害羞~快來吧⊙ω⊙戰舞姬iOS下載連結：： at 高雄新堀江商圈.	anticipation
Support .... So Cool <0 <0 <0  出世啦 ... 《 大情大性。講情講性》售賣點：書展 0000 圓方出版社攤位（0D-D00） 今個星期日 0月00日仲會有[PERSON] 《大情大性．講情講性》新書分享會時間：下午0:00至0:00記住黎支持啦 <0 <0 <0 .	anticipation
睏！磨石子[PERSON] 的聯絡方式吳政良0000000000高雄市瑞東一街00號(圖片、文字 全部轉自於好心FB網友：詠棋)(轉貼文)	anticipation
網(小) 乙支 價值000元欖仁葉 乙包 價值00元總價值0000元優惠一組 0000元可現場選魚，魚隻照片不提供^^布蕾克國際水族台中市龍井區遠東街000號0樓(靠近東海藝術街)0000-000000(同LINE ID) at 布蕾克國際水族	anticipation
 DISC 是一种帮助个人瞭解自己、瞭解他人的工具，在生活上、职场上的运用相当广泛，也有多家企管顾问公司在销售以DISC理论为基础的评量以及训练课程 ，更且许多大企业也采用DISC做为招募人才的参考。 有关更多 ” 人际学训练营” 的信息，请联系 Lynn (000-0000000) . 谢谢! with Edward Sk and 0...	anticipation
[PERSON]  建議官方剔除巨象防龍 	anticipation
 - 快d poke我inbox我！	anticipation
 有沒有人買好奇的尿布,可以幫忙我集點換這個車吖～拜託拜託啦～ 	anticipation
 0000/00/00(六)00:00 奧薩蘇納 VS 皇家馬德里	anticipation
 破产了啦情侣 装和手表，玩到疯今天在这小头家过夜啦～ with Lily Ong.	anticipation
全家趕快雨過天晴，大家的愛心會ㄧ直圍繞著你們，黃昏市場黃金屋壽司敬上 at 花蓮吉安黃昏市場	anticipation
So good  噚日睇完新聞，聽到[PERSON] 話唔會辭職，個心都定番啲 	anticipation
，輕者抽筋及昏迷，嚴重者可能猝死。 而且電腦屏幕發出的閃動強光，可能誘發羊癇症。若患有心臟病、羊癇症、肌肉痛症等，千萬不要沉迷激烈的上市條例，即使讀也不宜連續數小時坐在椅上，應每小時休息00分鐘。 每日讀上市條例四小時可上癮 社工則提醒家長，應該安排適當的活動給子女，留意他們上市條例的用途及時數，每日讀上市條例逾四小時已可能上癮，應要管制。	anticipation
O  沙頭角海膽仔龍舟隊 替駿義高興 金杯冠軍	anticipation
 虽然一直以来我孤独一个人的过，少了一个重要的伴侣在我身边支持我，T_T但是没关系，我还有我的事业可以让我发展到更好～很快的我又要回到打拼的生活了~fight!!! 	anticipation
。晉禾企業董事長[PERSON] 表示，賑米將於00日上午九點整開始，地點就在岡山區壽天宮外的公園路上，排隊起點為紅色牌樓的鳥居處，將發放一萬包米領完為止，或發放至十一點準時結束。 	anticipation
 说不是0母子也没人相信！！！！ 	anticipation
 难得珍惜。	anticipation
 二零一四马年到，海鸥直销祝您的事业如马攀翠竹，扶摇直上, 身体似马般灵动，平安健康。愿您与您家人马年福禄寿，新年快乐合家欢，马到功成！恭喜！恭喜！HOM wish you and your family luck in the Year of the Horse; Happiness, Prosperity, Longevity. Gong Xi F	anticipation
不但免費而且現場還有很多好康跟禮物等您來把它們都帶回家喔!!!到時請別說我Bo Jio啊:)到時0月0號Sungai Petani Village Mall 見咯!!!不要放飛機蛤。哈哈哈	anticipation
 不要在放棄治療了...............學好撞球~從現在開始!!!請各位好友,同學們轉發分享喔!!天台與你共同跨越0000~天台撞球運動館~地址:桃園市文化街00號0F(近南門市場)電話:00-0000000 at 天台撞球館 人人有球打.	anticipation
走入神魔世界。此外， BIGBANG 的副本關卡將會在「古神遺跡」出現，他們會化身英雄角色與召喚師一同歷險！各位召喚師如果想了解更多 BIGBANG 與《神魔之塔》的消息，可以繼續留意《神魔之塔》官方粉絲團報導！	anticipation
網、天下雜誌、快樂工作人、癮科技、VR-ZONE、遊戲基地、YAM天空部落、商周、鉅亨網、YES 娛樂戶外(00:00播出)：台北/忠孝復興SOGO、台北/明曜百貨、台北/美麗華百樂園、高雄/三多商圈、台北/南京商圈電視牆、台北/新光A0電視牆敬請期待	anticipation
 马来西亚最具权威的风水大师拿督Joey Yap将在来临的星期日在双威会议中心与您探讨蛇年尾声最有价值和最具潜质的物业投资。时间从早上十一点至下午六点，现场有神秘的大惊喜等待着你！欲知详情，请致电Wilson 000-0000000 或 Matthew 000-0000000。位子有限，先到先得！如此难得的风水地产盛会，你有什么理由错过呢！？	anticipation
BOTOX ESSENCE 0ML X 00PC （Free Azuline Sensitive Ampoule） C~ FIRMING COLLAGEN ESSENCE 0ML X 00PC （Free Acne Ampoule） Normal Price 【RM000】NOW RM000 ONly！（Crazy Price）Save RM000 赶快联系~ wechat:sooting0000	anticipation
Please share, thanks~  【肥肥尋家】0歲半。男仔。已絕育。全白史納沙。肥肥：我係被主人遺棄後，有人送了我去愛協，再被好心人救出的~我好想有個家，希望大家幫我忙分享，等我不置於流離失所，謝謝大家！有意請pm聯絡，需家訪，居住環境可以養狗！P.S.代朋友post.... 	anticipation
ㄜ  人生，就是一個修練的過程，何必用這一顆不平的心看待人和事，作踐了自己，辜負了歲月。我們無法左右命運，却可以選擇怎樣面對現實。愛比恨更偉大，寬容比懲罰更有力量，所有的無知行徑都可以原諒，也請善待自己，諸惡莫作，諸善奉行。感恩師父~南無阿彌陀佛!!! 	anticipation
的去贏得獲勝…但是專注【贏得重要的比賽】，就會帶來最大的效益及知名度！	anticipation
，把毛孔内的堵塞物清除。有机双氧科技对肌肤细胞进行修复工程使用后的效果绝对让你们肌肤更洁白清爽有弹力，而且不会有任何紧绷感觉！有兴趣的朋友们快快留言或PM漂亮店主 Luff Jen Z，绝对值得拥有^^ with Luff Jen	anticipation
拥有马来西亚卫生部KKM合格核准Inbox/ wechat/ WhatsApp 0000000000	anticipation
 謝謝在背後中傷過我的人謝謝你們嘲笑看不起我的人我也很謝謝在背後默默支持我的人！ with 尤刺蝟.	anticipation
 YEAH YEAH~ [PERSON] 已經幫大家買咗啦！可以快d 帶返屋企用啦>V<除咗幫大家買野之外，我都買咗支 BB沐浴露俾我嘅姨甥bb ^v^ 因為見到姨甥bb 皮膚唔太好，好似有d 輕微濕疹。好多媽媽都介紹用呢隻沐浴露，所以我決定買比bb。 with Wai Yu Mattew Chan and Sin Ying Li.	anticipation
十点刷话题走起！！！------------跟着我们泰京偶吧的节奏～♪♬摆动你们的小手♪ ~(ง˙o˙)ว (ว˙o˙)ง (ง˙o˙)ว (ว˙o˙)งthreedays ♩♪♫♬ ♩♪♫♬ threedays ♩♪♫♬ threedays♩♪♫♬ threedays ♩♪♫♬ threedays ♩♪♫♬ with Peanutsnoopy Lucy	anticipation
Lol  坐，也要有坐相吧？这位来自海外的人才的坐相如何？	anticipation
.... 超級替他開心的！！！ 我拿下女子組第一名， 嘿嘿～贏第二名00歲的幼齒0分鐘的感覺真是超爽的 <-- 我這樣算不算心態扭曲？！XDDD with Tim Easterday	anticipation
 祝我的各界代理 家人 在马年 马上发huat ar没有tag到的自己来 .	anticipation
 想瘦身又能修复皮肤纤维，就得试一下Bio Perfect Slimming Cream 。它含有脂肪分解物，能直接有效地作用于体会内脂肪，更快速面击碎顽固脂肪，通过毛孔排出，想瘦哪就瘦哪噢。。此外它还 能修复皮肤断裂纤维，壬辰纹以及难看的橙皮。	anticipation
）以便提供最好的服务！如有兴趣请留言... 谢谢 	anticipation
朋友讓我更相信世界上真的沒有醜女人，只有懶女人今年最大的不同是我開始規律的運動00'年底了，離目標還有一小段距離我會繼續努力下去朝更	anticipation
， 0月00日接下來，門票[PERSON] 00到000 （ VIP ）美元。信貸Okezone.com翻譯： Mongyi00ParkYoochunSGFC ：通過共享	anticipation
 新的一年裡讓我所有fb的好友們一帆風順，事業有成，家庭和偕，夫妻恩愛,,,,, 馬年行大運。 .	anticipation
 Happy Chinese New Year Eve ! 華人農曆新年除夕快樂 !要和家人一起熱熱鬧鬧的吃團圓飯噢噢噢噢噢	anticipation
 今年過年就決定穿這件齊天大聖在牌桌上大勝啦~台灣製造的潮T- 転(轉) Transform精梳棉舒適，內層刷毛保暖，修身剪裁不顯胖不知道穿上關聖帝君有沒有三寶退散的效果XD樂天市場 (用電腦開才有完整照片唷) .	anticipation
 我們是油力特潤滑油時間:00/00(00am~0pm)活動:輕檔車大會師地點:台北華山文創園區快來拍我跟小耶喔^_^ with 黃小耶 at 台北000.	anticipation
 00/00（六）起司大衛開幕當日，ＳＧ粉絲至起司大衛購買“主餐”，只要報上ＳＧ的名字，（ 主菜包含菜單前三頁：漢堡、義大利麵、沙拉、帕尼尼、黃金雞肉卷）結賬後即可獲得“起司大衛 現金折抵000元優待券”乙張！！，先放一張大家很素的照片，明天見哈	anticipation
Good  忙完了¾!!刚换电池和挑麦克风和音响！！挑了一个钟……妈的！！又要试过唱过才知道！！……唱歌⭕看电视⭕看新闻⭕看DVD⭕✌接下来…清洁厨房√清洁茶水间√打扫大厅√00:00pm搞掂！！ 	anticipation
發售。導演：[PERSON] 森執行監製：[PERSON] 編舞：Esther Cheng音樂總監：[PERSON] 	anticipation
On……  Ok 00号就要到了  到时见 不敢再放✈️✈️了 	anticipation
Yoon Kit  台湾文艺爱情片“等一个人的咖啡”已经浩浩荡荡拉队到马来西亚某个角落开拍咯～而且听说男主角还是我们马来西亚所熟悉的当地人哦～期待期待^^	anticipation
 这是小弟和朋友一起开的小小面包档，面包很新鲜都是在现场烤的，不含防腐剂也不含柔软剂！面包超松软的。。就在Taman Megah SS00 PJ的Ming Tien Food Court。。希望大家有去那一带或住哪附近的人去光顾光顾下。。。	anticipation
carol concert 幼兒英文繪本聖誕[PERSON] 因應大家熱烈詢問假日班課程, 叮叮老師跟噹噹老師我們決定為大家揪團開課！但前提是每班00人成團才會開班！以下0時段,請依代號留言登記報名：日期：00/0(星期六)(A)00:00~00:00(B)00:00~00:00費用: $000 (一對親子) 材料費: Free 全免!地點: 近捷運站 (報名成功場地私訊告知) with...	anticipation
 自家姊妹頭髮當色盤在玩，老爸已經麻痺了，因為媽咪說她們在試顏色，且有欣盈重建怎麼染也不怕變爛髮！老爸也覺得，恩不錯唷(///▽///)  at 髮妍造型坊.	anticipation
 宝贝扮美美要跟妈咪去shopping咯！ with Tee Tan Chin Choy.	anticipation
: 高雄市新興區中山一路00號	anticipation
good girls  宝贝想你是我唯一的消遣爱你是我唯有的希望 .	anticipation
 SY0時尚酒館 各位親愛的好友們:SY0除夕夜及大年初一休息0天，大年初二就開店與大家相聚!大年初三(星期天)不休息，歡迎大家過年期間來SY0共享年節歡樂氣氛囉^_^  at sy0時尚酒館.	anticipation
S&M i love it  S&M 抽獎活動開跑了!!!!!只要你按讚分享這張照片(要設為公開)在底下留言	anticipation
----------------------------------現在特價000元，五盒以上另有優惠。歡迎弟兄姐妹來電洽詢【溪水旁網路福音書房】00-00000000 /0000-000000 訂購 謝謝✿‿✿ — 在【溪水旁網路福音書房】	anticipation
Wow...  拉上另一半一起健身吧 <0	anticipation
！按下面條link就可以睇到。最好在laptop/desktop上面觀看，記得要開聲啊。如果要輸入ID，請輸入'aed0' with Celia Hung.  Brisbane Wedding Photographer...	anticipation
lol...  噚日睇完新聞，聽到[PERSON] 話唔會辭職，個心都定番啲 	anticipation
 春節0/00～0/0公休0天造成不便敬請見諒！過年前要漂漂的寶貝們趕快跟Emily預約喲！ 	anticipation
T-Share I see ur  恭賀VisaVis 斐瑟加拿大一週年與台灣斐瑟00週年活動 當[PERSON] 設計師精彩教學演出不可錯過還有小禮品等著你們來呦！0/00號禮拜日入場 時間 0:00pmWelcome	anticipation
Boon Kent  人生中第一架爱疯#iphone0#00GB	anticipation
/0000 （0pm）00/0/0000 （0pm & 0pm）票價： RM000 (VIP) , RM00 , RM00 Call / walk-in: klpac +000-0000 0000	anticipation
TERMINAL BOX (@Kuching Central, 0st floor, in front of Grand Supermart)  [PERSON] 新鲜燕窝终于在TERMINAL BOX可买到了！！！ 直采摘，直卖!!! [PERSON] 无加工 & [PERSON] 无漂白 (y) 价钱实惠到爆!!! 人人都能吃燕窝了～	anticipation
 一放寒假還是一刻也不得閒！一大早就要殺到北藝妖山排小女子的畢業製作⋯下午還要馬不停蹄的趕去北投幫文化大傳的畢製拍片⋯昨天像[PERSON] 復仇女神般的猛殺了對方一整天～殺人超光速combo連擊造成血流成河中我殺青了！殺人蠻好玩的！感謝 @匿名者 劇組愛護～今天無事一身輕，快樂的要返鄉了～呀！！！我、真、的、超、想、回、家、的！	anticipation
 下班好無聊,視訊鏡頭沒有人想跟我sk,只好自己來拍拍!!主題：『愛是唯一』 at 麥寮六輕員工宿舍.	anticipation
的睫毛是肉眼可以看出來的速度太厲害了!而且塗完母奶隔天睫毛尾端前面會有白白的部分到了晚上白白的地方會轉變成黑色睫毛!太神奇了!屢試不爽!所以現在有母奶的媽咪們一定要塗母奶!!別錯過大好時機喔!!!請大家告訴大家~~別浪費現成的母奶啊..一定要物盡其用啊!!! with 宮寶皮蛋 and Wu Mu Tasi	anticipation
人啊套房再便宜，也不能連個窗戶都沒有吧！ 你們這是黑店啊！居然連廁所...浴缸也沒有...」 醉漢越罵越大聲，小姐一聽也火了，大聲的回他話： 「趕快進來啦，這裡是電梯啦！」	anticipation
！感恩您们的信任和坚持。。。。。大家把QQ正能量的理念传承在马来西亚的每一个角落，造惠那里的家长和小天使吧！感恩分享。。。。您的亲戚朋友。QQ 的家人。。记得share哦！ 	anticipation
 萬眾期待，「西藏薰蒸」尖沙咀分店，已鐵定於0000年0月開業，店址位於九龍尖沙咀加連威老道00C-00D號嘉威大廈00樓 (全層)，面積達 0,000 餘呎。室內分別規劃為蒸身區、蒸足區、按摩室、穴位治療室，更設有休息區和化妝間提供寬敞空間給客人。「西藏薰蒸」將有更多好消息和優惠會陸續公佈，密切留意！.hk ...	anticipation
 今年過年活動！滿0000，抽汽車！	anticipation
 来听歌喝酒 Chloe Chen姐姐你太早走了啦 Zegna Goh帅哥已醉哈哈 with 帆帆 	anticipation
與選召是沒有後悔的。┐ 羅00：00主！賜給我們明辨的心，使我明白必須留心自己傾聽對象。我知道連我都可能對自己說謊，因此，我更加渴慕祢的話，能勝過那些試圖控制我、綑綁我的信息。我渴望活出祢造我的樣式。奉耶穌的名禱告，阿們！BY~活出全新的你~ . 未完成....	anticipation
 新年佳節買桶[PERSON] 回家慶祝喝喝吧^^造型精緻 0Litter 有興趣的朋友PM我吧~ .	anticipation
 我的小小太陽~~❤️❤️❤️(正面能量思考) 	anticipation
 & 好朋友們……有這個都會裡最精華地段的《空中花園》是不是好棒啊……你、我可以是個創造家自由創作……喜歡甚麼樣子隨你開心……可以是個（放空、 發想、發呆的地方、也可以是喝咖啡的地方、或看看底下馬路上來來去去的人群…………）	anticipation
Pei Lin Tsai  ★新品種 草泥馬狗狗出現☆你沒有看錯!!!! 再靠近一點~~~~我看起來像是貴賓混臘腸但是我超乖會握手坐下喜歡抱抱目前求包養想看草泥馬就帶我走吧!!! ◎公◎成犬(預估0歲以上)◎體型中型偏瘦◎地區高雄◇◆喜歡就別猶豫嘿◇◆已治療腹水及心絲蟲 逼啵有心臟病的問題需定期服用藥物(*_*) with 憨集憨集...	anticipation
巷00號(高雄理想國)預約電話:0000000000Line Id : gaigai000000歡迎提前預約喔！ at 甜妡美睫	anticipation
Woo~~~  澳門大學橫琴校區的超級市場竟然有咁多避孕套買！整件事情馬上變得很淫蕩這真的是大學裏的便利店嗎？難道還是要用它來上性教育課？ 	fear
！-！  ~~~~~~~~~~尋狗啟事~~~~~~~~~~犬名：Lucky走失時間：七月十一日走失地點：虎尾鎮廉使里往墾地里高鐵下方因已走失近一個月沒有下落，主人非常著急擔心，顧而祭出賞金，懇請鄉親朋友們幫幫忙！聯絡電話：0000000000 謝謝！狗主人：[PERSON] 標注到的朋友請見諒，若有打擾與反感請告知且自行移除，謝謝！！！ ...	fear
OMG  男人要去偷吃前想一想你家里的女人是否会等你回到家时把你这样，男人啊可要小心哦不好望了啊 	fear
[PERSON] Yong  太恐怖了啦，請大家不要再給小朋友戴了我記得小時候我媽都說橡皮筋不可以戴在手上，但為什麼這年代居然會有這種玩意？！而且都大陸製造，我真不敢想像這種東西有多傷害皮膚！ with Siu Wai.	fear
Read abt it!!!  太恐怖了啦，請大家不要再給小朋友戴了我記得小時候我媽都說橡皮筋不可以戴在手上，但為什麼這年代居然會有這種玩意？！而且都大陸製造，我真不敢想像這種東西有多傷害皮膚！ with Siu Wai.	fear
導致胎兒頭過小；研究發現，新生兒頭的大小與智力發育有關，孕婦服用高劑量維生素Ａ，可能影響胎兒智力成長。對於腎臟功能不佳者，基本衛教準則：「禁服脂溶性維生素Ａ、Ｄ、Ｅ、Ｋ，維生素Ｃ每日攝取量不得超過一百單位。」違反這項原則，[PERSON] 患者「不可負荷之重」！市面上保健食品，化學成份含量偏高，要吃對保健食品！！	fear
See!stop this toys  太恐怖了啦，請大家不要再給小朋友戴了我記得小時候我媽都說橡皮筋不可以戴在手上，但為什麼這年代居然會有這種玩意？！而且都大陸製造，我真不敢想像這種東西有多傷害皮膚！ with Siu Wai.	fear
，如化妆水，香水，尿布等，把它们扔掉。政府害怕，这可能是另一种恐怖主义行为。他们不会在新闻宣布，因为他们不想制造恐慌或给恐怖分子的新思路。发送给您的朋友和家人。最温暖的问候，美玲鹰阁医院有限公司人力资源部电话：00-0000 0000 00-0000 0000传真：00-0000 0000b  	fear
 我們兩個都上特等 意思是今年不發都不行嗎? 可是就在剛剛我才飛了0000耶 難道這要告訴我有失才有得? with MiMi Chen.	joy
能除此之外也用不同的方式關注自己看看或許也是個不錯的自癒我想從現在開始我會喜歡上關注自己的溫度讓自己暖暖的是好事啊：Ｄ	joy
 哈哈大家跟着包就不会破坏行情了 . 全部现货～	joy
 帮忙分享,感激....	joy
 這台讚吼~ with 鐘勝賓.	joy
 今天老爸生日！ 生日快乐啦~~ with Chung LeePing and Koh Jun Hao.	joy
 農曆春節毛家族新春禮拜時間：農曆大年初一，主後0000年0月00日(星期五)地點：玉井鄉井仔腳活動內容：感恩禮拜，歡樂團圓。很快的，一年又過了，我們再度回到祖厝一起相聚團圓，感恩上帝的恩典。能出席的答聲	joy
的幸运色。需要顾忌的颜色是红色、绿色、粉红色、紫色。属狗0000年幸运色生肖属狗的人0000年幸运颜色为褐色、灰色、米黄色、红色、白色。0000年忌讳颜色为绿色、青色、蓝色。属猪0000年幸运色 属猪的人0000年的幸运颜色是白色、黑色、蓝色、灰色，忌讳颜色为红色、橙色、黄色。 	joy
 Fucking Bitch 衣 和 原宿galaxy手链 都来自^_^ 里面还有卖很多东西，快进去逛逛吧 ❤️❤️❤️❤️ with Greentea Angelling Llz.	joy
ㄞ  一比較才發現我真的瘦下來了。人整個也給他漂亮起來了。目標在瘦五公斤加油!!! .	joy
 新年快到了^^开始做糕(kuih kah pet)了 ^^	joy
.  因原飼主心臟病逝兩隻親人愛撒嬌會回話的貓寶貝送養信吉->白底虎斑-公貓-0歲-已結紮親人親貓-愛撒嬌,會回話[PERSON] ->全虎斑-公貓-0歲-已結紮 親人親貓-愛撒嬌,會回話喜歡有意願認養的請跟我聯繫唷(*^o^*) at 貓寶貝中途送養的家. 寶姐家的愛貓阿!!一隻ㄧ隻都過著爽日子阿!![PERSON] !!	joy
socute!!!!! :)  球球昨天精神跟胃口已經恢復很多，媽媽說搶吃東西的土匪樣又開始了♡希望腸子能趕快消腫，不然天天醫院報到，又是打針又是吊點滴的好可憐。	joy
 冬天天氣冷皮膚都比較容易乾，一定都要擦個乳液皮膚才不會乾[PERSON] 的，這瓶乳液是我用過超過半年以上到目前為止覺得最好用的一瓶，它很保濕，清爽擦起來完全不油膩，肌膚比較敏感的人也可以擦，而且夏天擦也很適合<0自己本身對保養品很挑剔，這罐真的很很好用值得推薦	joy
 S妹來升級 義大利 BITUBO 專用避震...... at 健弘車業.	joy
Yi Zing Tan RIP  今天中午SMKDSE发生了一场命案死者Yi Zing Tan因割脉自残失血过多而死亡  	joy
。因爲物資捐贈者太多也不能盡録.....在此我細B媽代表所有受助的毛孩多謝你們 ! 祝願大家及毛孩生活愉快及身體健康 ! 你們的捐贈必定幫到毛孩們得到溫飽地渡過嚴寒的冬天。 	joy
 感謝遠道由加拿大來港的音樂大師鍾[PERSON] 先生蒞臨敝堂分享信息，見證神的奇異恩典，詳細講述他患癌至康復的經歷，讓人再次對上主醫治的大能更深的堅信肯定。願主親自保守他的人生此後更剛強健壯，繼續為上主發光發熱。  at 基督教善樂堂.	joy
、如果你碍于情面，低目标，低要求，低标准养了一群小绵羊、老油条，小白兔。这是对下属最大的不负责任! 因为这只会助长他们的任性、嫉妒和懒惰。让你的下属因为你而成长，拥有正确的人生观，价值观，并具备了完善的品行。让员工不断的成长，就是领导对下属最伟大的爱 	joy
 这几天心情让肠胃不大好 ( 这餐吃 Bak Kut tea 就好了吧 ) , Hehehe 朋友午安愉快呀 , , , , , , , , , , , , , , ,	joy
 推薦軟體~ 藍光濾波器使用手機時，眼睛比較舒適不刺激！ at 大日奕企業社.	joy
 粉紅[PERSON] 	joy
 戀上了白酒讓人舒暢的這種感覺，即使是這令人瑟縮的冬天，喝了還是讓人心暢神怡呀！這來自義大利的Di San Marzano一開始酸度比較明顯，舒服且沒有壓力，來隻Davidoff Grand Cru No.0整個非常協調令人開心呀！  	joy
家承)營 業 員 : 劉榆涵0000-000-000(榆涵)營 業 員 : 劉維群0000-000-000(小劉)營 業 員 : [PERSON] 0000-000-000([PERSON] )~台灣房屋歸仁特許加盟店~(小賴團隊敬上)  at 台灣房屋歸仁店-小賴團隊	joy
，別人不學你要學！』00.由前方指揮後方，而不是後方指揮前方﹔後勤是支援、服務和監管中心，而不是中央管控中心。00.我們一直摸著石頭過河，遲早有一天會掉[PERSON] 向世界級企業學習。世界上最難的事是革自己的命，但企業想要永續就非做不可。00.華為人對失敗的害怕很強烈，求知的慾望很饑渴，永遠在問『世界第一流是怎麼做到的￡』	joy
 创意无限 ~ with 守護甜心.	joy
SbS bus driver (Y)  SBS 0000Z bus 000这个司机值得给个赞下大雨了，他还出来帮忙开雨伞遮雨让乘客不被雨淋到即使自己已经被淋湿。	joy
 想不想加强您孩子对数学的运算能力？只需短短的00堂课，您的孩子就可以做到，欢迎家长们也来了解及体验一下	joy
 經過幾天的努力大家終於完成了，也等於日立盃快到了，大家加油～^_^和妞妞、小花  and 呂麗梅.	joy
风趣，讲课生动，可以和你们聊00，也愿意和你们分享生活趣事，同时可以教到你们很多的知识，嘿嘿~~~还不快来成为我课室的一份子？我在这里等你们^_^不信？那就来免费试补吧！！！	joy
 妳們快點來買乳液唷香香的又好吸收丸丸辛苦妳了 with 蕭幼貞 at 逢甲歡樂星.	joy
 老婆为什么要用老公的钱？因为“夫”字倒过来是“￥”,丈夫反过来是念“付账”。多么痛的领悟啊~ with Cheah Chui Jing [PERSON] and Nikki Woo.	joy
 台中晚安~大家晚安~很開心剛剛接到我阿母打來關心我的電話~我的心很溫暖~很感恩~	joy
[PERSON]  早安，来运动	joy
 ~阿里山隙頂小鎮 ,這個位置正好是面對日出的位置喔~	joy
 噓………！！剛剛偷拍了一下我兒的“立體美勞作品”，因為，他不准我把他的作品放上來，他說:媽咪~妳很笨勒，這樣別人會偷學我的作品啦！！但是，我還是很想與眾分享他的巧思及構思~沒法度ㄋㄟ~~~Y(*-*)Y	joy
 感謝好友 張綾珍送的「頂級生機綜合堅果」這是完全不調味，新鮮烘培製成，堅果富含不飽合脂肪酸，高蛋白質，維生素E等豐富營養，素食者可食今年第一天上班就收到，感覺很窩心	joy
』所以大家天冷也可以多多吃好彩頭啊！對身體以及胃都非常好喔～也讓我們用吃來支持友善種植以及有機的在地小農喔 :)PS.目前三芝有機農場的蔬菜是供給社區宅配、學校為主，假日也開放遊客來農場參觀，除了生產之外，也是教育和觀光休閒的好去處喔。 三芝有機農場地　　址：新北市三芝區中正路三段(馬偕護專旁)聯絡電話：(00)0000-0000 at 三芝有機農場	joy
[PERSON]  每每路过吉隆坡怡保律，都会享受这老伯经营有三十多年的糖水，绿豆汤和六味是我对它的最愛…三十年水准还是保着…赞!	joy
. at 家香友力美食中心	joy
 tone Excel 就是那么简单(^_^)想得简单，做就简单，赚得简单	joy
 感謝大家厚愛，今日本舖茶飲快要售完了，還沒喝到的捧油要快阿。 with 王潮男 and 吳家樺 at 台北小吳玫瑰檸檬茶創始本舖三重三和店.	joy
 和老公出街去了。。。	joy
 從初一上班到初六今天終休假了，和媽媽到醫美中心做臉，做完臉白的跟鬼一樣，又去探班看我的甜心Sammi ，像觀光客一樣買了好多伴手禮，也吃了好吃的日本料理，和巧遇威秀寶寶和他馬子，西門町半日遊好充實！已累攤～～ with Nina Wang.	joy
 凱璿不動產物件最多～配對最快～又有額外紅包～	joy
So cute  中午好 。祝朋友新年顺利发财 。喝午茶开心了 。Hehehe .	joy
 各位客倌新年好ヾ(*´∀｀*)ﾉ!!!為了維持[PERSON] 小孩的服務品質&美容師的生活品質。本工作室有三個禁止行為ㄛ(^ω^): 殺 價、魯 小 小、不 預 約。是說非常跩沒錯。但本人已經躲起來，保持隱密與低調，您還找的到，就煩請務必遵守本店規則，品質始終來自於堅持，感謝各位的厚愛ㄛ。啾咪\\(>ω0)。 	joy
 你有电脑吗？会看中文吗？会玩FB吗？如果你都符合的话，你都可以上网赚钱啦。目前我都靠这让我出国旅行也有钱领哦你可以先注册了解，不明白我可以教你请点此报名  .	joy
 真人實際操作課程虹屹把麻豆畫的很美呦這個妹妹有小小明星臉ㄟ今天⋯發生一件很爆笑的事還好我即早發現～即早''治療''不然依照往例～哎～再說一次那個啥～樣的⋯跟我們一點都沒有關係喔感謝大家的關心（鞠躬） with 賴虹屹.	joy
 很多时候，不快乐并不是因为快乐的条件没有齐备，而是因为活得还不够简单。	joy
 今年冬至在新加坡和我最亲爱的姐妹们过 <0 	joy
Good idea . DIY Jesslyn Lai ,Patrick Chong  模仿了粘妈Bibi Crystal的DIY手作…训练宝贝辨认颜色…粘妈，谢谢你！因为你我学到了很多！大家也试一试吧…。 with Kimho Chua.	joy
飲料喝還能健康加分唷!!!!!!熱烈團購已開跑！快私訊我吧	joy
 雖然已經過了，但這個還是很酷^^	joy
 今天要跟家人出去 踏青全家都在等我一個 抓頭髮 換衣服 所以我好趕好趕好趕 .. = = 長那麼大 老爸第一次跟我們一起去玩欸還滿開心的 XDD 話說 我最愛的招牌動作 應該就是 兩隻手一起比 YA了 XD實在不知道有什麼 POS可以擺 要不就是耍帥插口袋 不然就是比 YA with Weasley Jin.	joy
Jimmy Lim,Teoh Cheng Yen Juliana,Shelly Lim  巴生人 是selangor baby就 快快去申请和拿罢。。。goverment给的我们就要拿罢了。。	joy
lOl !!!  下次,就送这样	joy
[PERSON]  早安！祝福各位弟兄弟姐妹和朋友们，有平安喜乐，有神同在，恩典不尽，福杯满溢，信心满满，身体健康，凡事兴盛，出入蒙福。感谢主，阿们！ .	joy
.seventeen.com.tw/html/ac/00.aspx?num=00&kind=000/0 台中(午場) 0/00 桃園神社-浴衣主題外拍(早場) with Yi-Ting Jiang	joy
 為了協會成立十週年的活動，從兩個月前就開始準備，到澎湖港邊等魚船回港，現挑搶購魚獲，現場要馬上放血保鮮，再空運回台處理保存，特別選在今天製作日本鄉村土佐式生魚片，更特別情商兒子方南放下手邊工作到現場現做日式捲壽司，讓所有會員朋友品嚐，看他們吃的開心又滿足，感恩有此機會會大家服務，付出比得到的更開心	joy
 婆婆的年糕 with 陳英妹 at 溫暖的奶奶家.	joy
一半但卻又有多少在批評另一半厭倦另一半當你單身你渴望有人陪當你穩定你渴望自由剛在一起我會照顧你一輩子後來離我遠一點請記得無論誰都沒義務對你好愛上你要珍惜那得來不易你擁有的說不定就是別人想要的！！	joy
 賀！ 英文00, 自然00, 社會00, 數學00, 國語00.0, 健康00 ,進步七名, 全班第0名, 進步0.0分, 得到學校轉頒的進步獎獎狀！	joy
。按讚破 00000、分享破 000：抽0位。按讚破 00000、分享破 000：抽0位。按讚破 00000、分享破 000：抽00位。※得獎人如封面照有更換成 水巫小雪新封面，則再加送一張小雪簽名拍立得。※ with 莊詠惠 and Winnie Chuang. WINNIE.SNOW:+LIFE...	joy
 我的宝贝昨天陪爸爸妈妈走了很久的shopping…无聊到在那里摆出奇奇怪怪的姿势…芬芬	joy
我們歡聚臉書，共同來祝福彼此，祝福大家天天好心情，心想事成，平安幸福快樂！…… with Raymond Kit	joy
 又完成一张人物画了xD人物名字: 索[PERSON] 橡木盾电影《The Hobbit》的角色~画了一个星期~不过知道这个角色的人应该不多吧=p	joy
 今天終於有比前幾天溫度高一些了,希望明天的天氣也會像今天一樣舒服宜人~星期六(0/00 )00:00有空記得來鳳甲美術館聽聽CIM鳳甲音樂沙龍喔! with 鳳甲.	joy
 一年一度的五香大会，我们的掌门人“将小姐”与两门徒！林大和包赢！	joy
色- 不过敏- 不生锈- 光感好RM00包邮 — 	joy
 最大的幸福不是得到，而是知足！最好的財富不是金錢，而是健康！最棒的祝福不是將來，而是現在！最多的自由不是擁有，而是放下！值得的就去珍藏，擁有到就去珍惜，幸福的就去享受，隨心而為！早安好友！週未順心愉快！	joy
Good job  Science Quize Show今天頒獎，這是得到第二名的獎牌！這小姐粉開心……	joy
 人生旅途上、不如意十之八九、想開自然好好活下創造美好的將來、互相鼓勵讓生活多彩多姿開心	joy
效果最好。歡迎參考 ♥歡迎分享 ♥【相知相惜】【夢中人-[PERSON] 】心情日記 ♥ 	joy
 這會不會是史上第一個個人攝影project改編成舞蹈劇場的作品呢？感謝Debra Chan超強的執行力以及重承諾説到做到的信念，在香港澳門的朋友們歡迎一起去欣賞悲傷的不同形式吧。 .	joy
时肉汁会流失先把不沾底的平底锅烧热加入冷油（不需要很多），把包放入锅内，转中火让它煎一下，再加 0汤匙水盖上锅盖让它煎到干水，然后把另一面煎到金黄色就可以起锅了！！香喷喷的咸鱼包是超赞的点心。。一定要趁热吃才会有爆汁的感觉。。如果不要马上吃，我建议把包好的包子放入冰箱，要吃时才煎。。 祝大家成功啦。。。。	joy
Love yourself first  人生，重要的事很多每件事情的因果關係不是能照著自己的規劃而走。不要為了專注把一件事做到最好，而失去欣賞窗外許多的美好風景人生要均衡，我認為每件事做到無愧己心就可以了。	joy
 别半途而废,坚持着不该放弃的,好好守护着意念,就没有到达不了的彼岸!随写 .	joy
Sylvia Zeng Yie apply for ur baby  巴生人 是selangor baby就 快快去申请和拿罢。。。goverment给的我们就要拿罢了。。	joy
 00000000大衛台南新光三越B0速寫	joy
BEN  有時再累也要～把今天的成果看上一遍雖然還是那句老話..如果可以如何,又可以如何～不過這就是進步的樂趣與快樂的泉源吧～＾＾～一定要睡了><	joy
 微涼不寒的早上，相信大家舒服多了，敬祝大家周五心情愉快事事大順利。 at 美誼鋁門窗.	joy
  神奇哦~希望大家都口袋滿滿! with Supin Chen at 林公館.	joy
)♥宝宝圣品-能量胶霜 (消红肿,热痱,湿疹,尿布疹,蚊虫咬伤,伤口等等)欢迎大家的询问或订购♥ 	joy
 [PERSON] 亞提尼海	joy
 人生就是不斷的成長不斷的過關所以平時就要鍛煉過關的能力挫折 失敗 跌倒都不是悲劇放[PERSON] 才是當您發現沒有人可以靠時自己就該勇敢起來碰到沒有退路時 路自然就會呈現出來在悲觀者的眼裡生活的一半是煩惱另一半是如何消除煩惱而樂觀者的眼裡生活的一半是快樂另一半是如何享受快樂祝福好友們0000~新年快樂~吉祥如意~馬到成功~福慧雙全~	joy
 大家忙著放假回娘家或出去玩所以馬路上的車子整個大堵塞 然後老公騎車技術越來越好了ㄎㄎ ♥初一初二要想我蛤豬不豬到 ~ love you , my baby :-* 隱+0 at 唯伊甜蜜小窩 ♡.	joy
 Finally  Good night ❤️	joy
 今天的订单''杏仁酥 with Yeang Wei Foodstuff.	joy
我们的新baby 0000 第0天的月子餐^^谢谢家婆这几天早起帮我陪月,照顾0个孙子,老公做男佣帮我爬上爬下楼梯送食物给我,又特地请假在家帮忙顾宝宝和恬恬,真的觉得自己很幸福 ^_^ with Ann Sim and Vic Liew. 恬恬要当姐姐啦~期待与我的二宝见面^^	joy
Evon Chiok  穷的时期 , 妻子不离不弃 ,风生水起后 , 不抛妻弃子。Respect #DavidBeckham & #Victoria . Christopher Production <0	joy
Thanks for sharing ! 人生有很多的包袱，如果我們都不能放下，那快樂輕鬆將永遠與我們無緣了呦～朋友們 ： 周四愉快呦	joy
 Newbalance！Gorgeous！	joy
 賞櫻不用到陽明山，土城就有 ！ ，，，，，，(≧∇≦)	joy
…你也為自己多修了一條出路……Peter.邱… 與友共勉……圖/網路 0000/00/00	joy
 在吉隆坡合家欢--	joy
 ＂坏＂人就该换掉〜	joy
令人感動》任何一個工作崗位都是值得尊重的。By Fw～	joy
 宜蘭有牛舌餅 新竹有米粉 圓林有肉圓 台中有太陽餅 嘉義有方塊酥 北港有土豆 台南有蝨目魚湯 萬巒有豬腳 潮州有什麼？當然是這個 （勇伯蒸茶鴨）（[PERSON] ）節日送禮絕不漏氣 大人小孩都喜歡 地址在潮州老街 （三山國王廟附近）期待您的光臨 謝謝 at 勇伯蒸茶鴨.	joy
 三菱殿堂尾牙打漆彈烤肉聚！！！！(人多不標記) at 諾曼第漆彈營.	joy
 good morning最近工作壓力大臉長了一些痘痘!昨天一下班就趕去 星和醫學美容診所台北店 皮膚科找陳柏森醫師，請幫他幫我做淨膚雷射，今天早上皮膚好好喔！開心！！！下面照片是剛打完淨膚雷射的素顏照！明顯白了一些！！ at 星和醫學美容診所台北店. Vina粉絲團♥希望大家多多支持按讚及分享喔≧∇≦~♥	joy
 我希望你，00天後，冬至快樂，00天後，平安夜平平安安！ 00天後，聖誕節快快樂樂，00天後元旦快樂， 00天後除夕夜快樂，.00天後新年快樂， 00天後情人節快樂，00天後元宵節快樂！我就不信有人比我更早祝福你， 轉給你最好的朋友，..嘿嘿！！！別小氣呀！（今天收到請盡快發，遅發時間日期就不對呀	joy
 •。★❄ S H I N A W A T R A F A M I L Y ❄ 。* 。❄ ° 。 ° ˛˚˛ * _Π_____*。*˚ ˚ ˛❄ •˛•˚ */______/~＼。˚ ˚. •˛• ❄˚ ｜ 田田 ｜門｜ ˚ ⌒⌒⌒⌒⌒⌒⌒⌒ ⌒⌒⌒ H A P P Y M O N D A Y*~*~** .	joy
 三步骤有效改善毛孔粗大，只需0分钟轻柔按摩去除老废角质，促进肌肤新生，帮助抚平细纹及收缩毛孔！让你不再＂孔慌＂！	joy
 Open醬整個超可愛啊~~~~今天高雄到處都是人擠人 。。。駁二。Open-Z時空大冒險展 at 駁二藝術特區 蓬萊倉庫.	joy
 看牙齒還是要找有醫德的醫師 經過半年治療 省下00萬塊不用植牙了！	joy
cute  遲來的生日禮物，楊璸翰謝謝喔！！！超喜歡這生日禮物＾＾	joy
 今年大掃除~廚房抽油煙機的好幫手~ 不用再被威X猛先生,[PERSON] X士 ,嗆鼻嗆傷了~重點還不用帶口罩手套,輕輕鬆鬆~清潔女主人的	joy
 你是不是一个很喜欢旅行的人?你是不是一个很喜欢享受的人? 喜欢旅行但是每次存钱存到天天省吃省用?为的就是订购廉价飞机票去旅行? 你知道吗?只要你愿意电脑上网赚钱,你以后也能过着逍遥自在的生活! 还考虑什么?填表格>>  ,安装Skype联络我!让我教你上网合法赚钱! with...	joy
，里面有rm00,你就可以开始创业了。你想下值得不值得，喜欢不喜欢，什么问题可以问回我~有兴趣请加我好友后PM我吧～ . 0000 0000 000 david ng...	joy
危机的地方工作，生意人，网卖，直销喜欢挑战的朋友佩戴，祥威虎头象威威严克煞，能驱走小人，挡掉可能发生的意外，身体健康可以带来好运气，让工作顺手，生意兴隆。。还没有的朋友赶快pm我下定吧~汇款后马上发货(´v｀o)♡大虎RM00小虎RM00欢迎批发，代理... 	joy
Shan Shan Chew  分享好康~~在Guardia购买DOVE的产品满RM00即可获得一个Panasonic Hair Dryer♥♥存货有限，千万别错过咯(^_^)	joy
位。按讚破 00000、分享破 000：抽0位。按讚破 00000、分享破 000：抽0位。按讚破 00000、分享破 000：抽00位。※得獎人如封面照有更換成 水巫小雪新封面，則再加送一張小雪簽名拍立得。※ with 莊詠惠 and Winnie Chuang. WINNIE.SNOW:+LIFE...	joy
（0-00AM), 我与您空中有约 	joy
物排出 	joy
 來細細分享一下這次髮色～這次的髮型師是透過我的學生介紹的喔～我把自己大約想要的感覺告訴髮型師AMA一切就由她設計～沒想到成品比我預期還棒～顏色超飽和.又亮！還有我愛的繽紛色彩～髮型師很細心慢慢幫我上色～做出漸層的變化～今天出門一直被問髮色哪裡染～一直被誇好美～喜歡的朋友～想嘗試的朋友～可以試試看喔～ 	joy
 @@工商時報 刊~ ~ 今年台灣的百貨公司業績表現，第一名依然是北市太平洋崇光百貨……而我們台中市的新光三越台中店應該是第二名……而第三名還混沌不明？？《可能是台中大遠百、也可能是台南市的新光三越店》雙方都上看逾百億元營業額@@而中友百貨與廣三Sogo百貨也表現不差，應該是前七名之列……@@由上述數據看出我們台中市消費力超級強非常旺旺旺	joy
 有了她，我的生活多了很多麻烦。有了她，很多时候我都用娃娃音/叠字。有了她，我变得很容易感动。有了她，我的生活变得忙碌充实。有了她，时常晃神傻笑感恩老天。有了她，觉得世界可爱万分。被她需要，被她撒娇，被她气到，被她疼，被她娱乐，感觉都好得不得了！女儿哟… 我们手牵手一起走！Happy Birthday baby. ...	joy
将经过Harbour Bridge 和Opera House，然后前往Cockle Bay。分享我昨晚拍摄的祝大家有个愉快的周末。 	joy
 【學習英文數字組】手眼協調；創造能力；邏輯思考；分辨色彩；形狀認知 ★ 00 顆積木。 ★ 高品質荷木，植物水性漆，雙面印刷。 ★ 包含多樣顏色及形狀，滿足小寶貝的好奇心。 ★ 英文與數字增加寶貝的學習能力。   at 益啟玩 Each Win - 一起玩出想像力、創造力、邏輯思考力. Young Child Motivation In early education, an extrinsic...	joy
Tung-Cheng! Thanks for your drop on.  給張小柔情人節小花束！很特別的「彩虹玫瑰」！※感謝陳懇的香遇花藝設計！會場佈置、送禮花束等，有關花的問題都可以找他喔！ with Jia-Rou Chang and 陳懇.	joy
 生活就像一面鏡子，你對它笑，它自然對你笑，你對它怒，它自然對你怒，如果樂觀和善，它就給你一個慈眉善目！用什麽樣的態度看待生活，就擁有什麼樣的美麗人生！體驗一切，包容一切，平常心，耍知足，你的人生會更美好！好友早安！	joy
（又加上他們疼我 ） 還是掏腰包拿錢出來給我去買。長大後依然很懷念這牛奶的味道⋯我終於買到了！	joy
 或許下雨天讓人覺得濕濕黏黏很不舒服，換個心晴吧下雨讓我們有水喝，沒有雨我們又要鬧停水囉我還是乖乖的烘豆豆~ at 亞鷹咖啡館.	joy
 金蛇舞离骏马致，马年吉祥顺利好。一马当先前途广，事业成功业绩高。兴隆生意遍四海，滚滚金币如涨潮。爱情甜蜜家美满，幸福如意乐淘淘。开心快乐身边绕，全家老少都欢笑。祝您马年快乐! .	joy
Grace Lee Wendy Lee  巴生人 是selangor baby就 快快去申请和拿罢。。。goverment给的我们就要拿罢了。。	joy
个疗程后 都来报喜了	joy
 祝福大家新的一年鼠錢不完牛那樣壯 虎虎生威 兔氣揚眉 龍馬精神蛇得消費馬上有錢羊羊得意猴會有期雞不可失 狗用就好 豬您發財 :D at 使命必達([PERSON] )副議長服務處.	joy
My 'mermaid' team^△^/  维多利亚一曰营，认识你们很开心 <0 Happy Memories !! \(//∇//)\美人鱼队，魔幻世界，自由自在，如力向上，发啊！！！ xDD .	joy
 福容飯店進駐改造後變得好美哦！ at 淡水 漁人碼頭.	joy
」、傳真專線「00-0000000」；另警政署已結合智慧型手機「警政服務App」應用軟體「000 e化勤務指管系統」功能，開發新版「雲端視訊報案」App應用程式，提供民眾以視訊報案方式與000受理人員進行對談，民眾可透過App Store或Google Play免費下載安裝及更新，提供民眾更便捷的報案服務，請民眾多加利用。	joy
 女孩们，你是否每天忙忙碌碌却很迷茫？忙得没时间好好爱自己？再忙也要学会保养自己的皮肤，留住女人的资本！你若不会爱自己，等谁来爱？男生也可以的,呵呵!安全卫生的血液疗法，排毒靓肤，你会看到你的肌肤水感透白的转变! 想要健康光泽的皮肤，(提我的名字有优惠价) 快询问: Grace 000-0000000 with Grace Cheong	joy
=）有兴趣自行inbox我～不要叫我pm!照片全在相册了，可以自己去选色！谢谢=)欢迎来抢购！嘻嘻～	joy
hi morning, great pose....  今天工作有起士蛋糕吃ya at 000 Studio ｜攝影工作室.	joy
层是腮红=）有兴趣自行inbox我～不要叫我pm!照片全在相册了，可以自己去选色！谢谢=)欢迎来抢购！嘻嘻～	joy
Beautiful  休息室的塑料花和工程车模型	joy
 有需要的朋友⋯到不單單咖啡一江店找我們喲！ .	joy
 人生是场牌局假如觉得自己身材不够好那就去瘦身觉得自己长得不够漂亮那就去保养这是最切实有效的解决之道不可能让自己变得比其他女人好看但自己可以变得比以前的自己好看人生就是场牌局虽然我们有时会抓一手烂牌可打得好也会有精彩的过程和翻转的结局昨晚拍滴相片	joy
VERY GREAT !!  今天的家庭聚餐用气压锅和蒸炉煮了冬菇鸡脚,猪脚醋,妈蜜排骨,白斩鸡♡ 很方便 好用 (y)	joy
Lee Douglas  Vjian Liew你的手表收到了哦〜送一支给我吧〜我很喜欢呢| with Vjian Liew.	joy
Are you still waiting??  恭喜云吞面老板娘成功面交一位你还在犹豫吗?恭喜wong加入我们的大家庭一起赚钱 加油 	joy
 How many marks...?花了三小时才完成的马到功成画,送给在马年我快要出世的宝宝,爸爸爱你 .	joy
 在香港職業發展服務處嘅簡單訪問。正如標題	joy
效果哦! -->保质期 0年 -->净重 000g	joy
經營.(都更)一定是未來必走的路,如何利用都更幫我們創造錢潮,是我們一定要面對的事,唯有創造更多的就業機會,才能帶來富足的明天,后里是一盞明燈,它能點燃台灣的未來,(都更)是一種有利於民的方法,唯有透過都更,才能帶走我們的煩惱與憂愁.	joy
 二團團員模仿	joy
yes  谢谢你们!! 我妈妈看到自己突然拿第一很开心!!! 我也很开心!! 谢谢你们全部人的支持,感激不尽!	joy
 人，最好的心態是平靜；最佳的狀態是簡單；最棒的感覺是自由；最舒服的心情是保持童心。	joy
Brave Tian Kuro Neko-San Yong Chuan Leong Sowseng Lim WTF...  藍色小精靈~喔～我的童年~	joy
是一种挑战。Game的魅力在于它满足：表达、探索、合作、竞争的四大人本需求。可以娱乐，也可以教育，既可为模拟，亦可为现实，所以中某种意义上来说，Game是无处不在的。Life is, now, a Game Circle	joy
ㄟ  好康活動來嘍～[PERSON] 於0月0號星期六引進『醫療級百萬檢測儀器』早上00:00至下午0:00在台中向上店幫大家免費做皮膚檢測，歡迎對自己皮膚健康想了解更多的朋友可以邀約親朋好友過來做皮膚健康檢查喔！機會難得趕快把握。  at 王妃殿堂美麗生活館台中向上店.	joy
㋡	joy
 祝大家心想事成,马到功成 .	joy
。不管时代如何变化，自爱永远会让人觉得可贵。不要为别人委屈自己。你是唯一的你，珍贵的你，骄傲的你，美丽的你。	joy
联络我谢谢…请大家多多支持HANDS 	joy
hello zhong ming how ane you  我表妹她終於結婚了，祝賀他們幸福快樂，永結同心，恩恩愛愛，白头偕老！	joy
 《你寄给我,一张贺年片,三行两句,带着万语千言,声声的祝福,说不完的怀念,阵阵的的温暖,充满我的心田。。》每年收到贺年卡,总是让我想起这首百听厌,哼起来温馨满情的歌曲《一张贺年卡》。。。朋友,借助这张贺卡,我寄予大家祝福,祝大家龙马精神,马到功成^^早安愉悦。 .	joy
Doing good for being a wegetarian!  【吃素食】不是只是為了宗教信仰，還有地球環保，養顏美容，身體健康。（節能減碳，保護地球，大家一起來）	joy
後當我永遠的後盾，接下來的日子，會是我人生中一個很大的突破及轉變，沒有你們，就不會有今天的比比，比比在此恭祝大家新年快樂，所有伴我走過一切的，我愛你們，謝謝！！愛丟虎妹妹，忘了tag妮了，我補在這裡，我也愛妮，妮是最棒的～ 	joy
 年三十晚團年飯加00月，0月生日之星的生日會	joy
MAN's king肌肉猛男秀～gogoboyz  今天開始活動 飛[PERSON] 今日 桃園生日go 大家今日 man's king了嗎^_^	joy
干净和达到美白效果，还能散发魅力象拥有婴儿的纯净肌肤。。。有兴趣，请留言inbox 向我订购！:)	joy
 小哥哥跟媽媽說：媽媽。下次我們也帶一塊「大布」來好嗎？準備一片野餐布墊吧！台灣處處好風景隨時隨地享受這片土地的美好！媽媽說：妳們的「機私」真多＜準備了0）搖控汽車。大腳ㄚ0）棒球用具0）羽毛球具0）足球0）零嘴+水 其實。也還好〜^^•這天〜	joy
 小傢伙鐵定覺得很孤單，偷偷從縫裏瞄到牠老是坐在那裏發呆，要不就是喵喵叫～所以下午開完會就順便在附近書店買了小鬧鐘、毛巾襪（較軟厚）、軟綿綿布娃娃。回到家就把小鬧鐘裝好電池放入襪子內，再把布偶一同放在Miu Miu身邊。半小時後就成了這幅睡香香的模樣了。^_^	joy
，依違反毒品危害防制條例罪嫌，移送高雄地檢署偵辦。	joy
 Refillable 饮料！！ 喝了再喝！！无限量供应！套餐只需RM0.00起！快来STAGE CAFE享用！	joy
which better compares with dollys girls? lolz 剛和同事們一起吃大餐~很棒耶~大家吃飽了嗎！！我在這裡等大家來贊喔！！	joy
 世界唯一寶石珊瑚媽祖 保平安 賺大錢 ~~ at 南方澳進安宮.	joy
 奢华00K Gold Eye Gel 即将登场 ~~~特效去眼袋去黑眼圈、眼周细纹克星~~~	joy
Luke & Share HIN Malang Indonesia x DJ Leng Yein 当所有人都拿我当回事的时候，我不能太拿自己当回事。当所有人都不拿我当回事的时，我一定得瞧得上自己。这就是淡定，这就是从容。。。	joy
 前三名~哈哈	joy
 人是矛盾的动物，什么都没有的时候觉得什么都是好的，当有了熊掌之后却觉得鱼更好。人不能太贪心，不可能什么都如愿。我看到过这样一段话“穷人想当富翁，富翁想长生不老，长生不老的人无限烦恼。这样的日子什么时候是个头啊……”珍惜自己所拥有的才是关键。祝福大家身体健康，开心过每一天	joy
 祝大家新年快乐，万事如意，身体健康，但愿在这新的一年里国泰民安，消灾消难，平安吉祥!初一早上吃斋，准备煮[PERSON] 的材料，今早煮给家人吃，一家团圆乐融融。	joy
歲或以上！結論：百病皆生於氣！消氣法（分九個層次，逐級提升）：0、傾訴；0、回避；0、運動；0、娛樂；0、想得開；0、自己想適合自已的方法；0、換位思考；0、放得下；0、提高境界。請用你可愛的小手按下複製，發到朋友圈裡。不要只顧著自己笑哦！改變觀念！改變不好的生活習慣！關心自己！	joy
 来哦来哦…新年的年饼到了哦!!!有花生饼，月亮饼，牛油饼，四大天王饼，南瓜饼。存货有限哦，要的朋友可以来拿货哦!!!随机附送红包封和小礼物一份哦!!!	joy
Happy Vegas Day..  心地善良的人容貌一定动人心里知足的人生活一定快乐愿大家 消灾解难开路明灯卫赛节快乐 .	joy
 今天参观龙香制造厂…顺便买龙香，过年咯！	joy
 安全抵達！ with 張民雄 at 台中外埔溫暖的家.	joy
動力一直支持著我前進；晉升區域總經理，有更深的使命與責任，我會繼續努力，謝謝您們！	joy
 搞定老婆要返鄉的年貨、禮品一個月的俸祿，半天就給解放錢真的變薄了老婆高興就好！  at 暖暖台北大鎮.	joy
家庭的色彩。 其实中国人不会生活！你看了这个有何感想呢?同意的疯转！我同意。Happiest Garden's -[♥] 	joy
 東鋼鋼結構尾牙	joy
when come  韩国的丽齿健glister™…清新口气同时不含卡路里 	joy
agaun for the prayers!  老朋友可以吃粥了,她要上FB告知关心她的朋友勿念!	joy
 [PERSON] Polo男生衣服[PERSON] cotton新年要到了,买给爸爸,家公,老公,男朋友,朋友。最好的礼物	joy
000 號(大潤發量販店旁第三間）  	joy
！！我們只想傳輸一個正確保養和彩粧的觀念，就算上完課沒有銷售，我們也很開心！請不要再問我要打幾折，我給你的服務從來沒打折ㄛ ！我們也只是賺你合理的服務費	joy
 新裝備帶來新鳥運~終於拍到了美麗的夢幻鳥~	joy
！  早上好朋友们,小周末愉悦欢乐祥和,温馨浪漫,长在我们的身旁♥♥希望大家都能够幸福欢欢喜喜地度过每一天♥♥ with Wan Lailin at Kampung Baru Cina Mambang Diawan.	joy
。上課時間：00年0月0日至0月00日 (0/0停課一次) ，週五晚上0:00～0:00， 共00小時/00週。上課地點：嘉義市清江學習大樓(世賢路四段000號)。歡迎報名：	joy
Arrow Er [PERSON]  限量版马年ezlink卡 祝大家情人节+元宵节快乐 马年马上有钱^_^	joy
Gogo~  接白沙屯媽祖到北港朝天宮 at 台00線.	joy
 新年快樂 外頭炮聲不斷耶姐今年不宜賭博 明天要去哪裡玩呢  with 黃兆浩 and 黃靖凱 at 0000新年快樂.	joy
[PERSON]  刚出炉热腾腾的面包。。	joy
太平。..轉貼..~~~早安 吉祥 愉悅~~~ at 台北市士林官邸	joy
 把握最快樂的假期到天后宮走走，讓媽祖婆摸摸頭，帶走滿滿的溫暖與慈愛。初五接神~祝好朋友們開工大吉。 at 鹿港天后宮.	joy
 親愛的，想要享受spa級的深層潔敷泥嗎？裡面富含德國黑森林區天然火山泥能吸出肌膚深層髒污及油脂，同時補充礦物質與養份呢並且含有乳鐵蛋白丶vit E丶薰衣草萃取液、甘菊萃取液⋯⋯親愛的你們想體驗嗎？～歡迎和我預約美容課喲❤️❤️❤️	joy
,参加就对咯!)**截止日期00♥00♥0000 , 00pm**为了以防万一参赛者拥有多个fb 户口，不是真人个人头像会被取消参赛资格哦!	joy
 鼠牛虎兔㔫蛇马羊猴鸡狗猪。在看电影❤️一路有你。	joy
 不要去抗拒会发生的事因为这是改变不了什么您能做得只有享受当下您能做得只有赶快完成您能做得就是好好规划我知道你会做的很好^_^迎接《0000》的到来… 加油哦!	joy
 外出午餐ing…	joy
 我希望你，00天後，..冬至快樂，00天後，平安夜平平安安！00天後，聖誕節快快樂樂00天後元旦快樂，00天後除夕夜快樂，..00天後新年快樂，00天後情人節快樂，00天後元宵節快樂！我就不信有人比我更早祝福你，轉給你最好的朋友，..嘿嘿！！！別小氣呀！((((今天收到請盡快發，遅發時間日期就不對呀	joy
 自己另外一个作品，在fb学滴，愿我家人亲戚，朋友，网友，步步高升，事事如意，财源广进，重要身体健康，新年快乐！ .	joy
(y) :)  MalaysiaSingapore✈Dubai 第一次一人飞那么远 安全抵达迪拜☺ at Dubai International Airport - Terminal 0. facebook inbox order: order:Yunice0000Wechat order:Yunice0000Call order:00-0000000 (...	joy
 晚上依然是UG時代……今天很幸福一到場就有好多我們最愛的食物和飲料……然後吃飽在學嘟嘴魚……原本嘟嘴就會有漏氣聲的澎跟豆被我教會了唉…… at Tayih Landis Hotel Tainan 台南大億麗緻酒店.	joy
 每一滴水都折射出一個多彩的世界，每一雙眼睛都嵌進一個多彩的世界，每一條泛著清麗的旋律的小溪都閃爍著美的光輝。不要空嘆人世的無奈，且用美麗的心情來看待人世的繁華多彩，細細品味那無處不在的美吧！..轉載..祝福您... with Chang Yee Soo and 賴小蓮.	joy
Huang夤Yin僡Hui。。以后你们要叫我新名, 不许再叫我Yi Xin 或 yee heong lo, I will not answer u ok...你们给我的称呼会带给我最大的祝福。。。谢谢大家的合作咯!!:):)	joy
GOOD  今天(((((((它)))))))害我笑了 :-)	joy
How Are you today ?  我柬普赛 Siem Reap 的朋友-秋香 .	joy
出我們的愛與祝福更要去愛你 我的主 求你使我們的生命 才能 時間 精力與金錢加增我們的智慧與力量去把福音傳遍地極讓更多的人得著永生的盼望求主保守我們的心謙卑回轉 時時求告你不論在順境還是逆境都感謝你的靈 親自在我們的生命中做工讓我們得享生命的富足心靈的喜悅與平安我們原所不配這樣的禱告乃是奉主[PERSON] 的名求阿門  at...	joy
 朋友們~晚上好哦!!像不像穿著婚紗的新娘?!!雖然我只有梅花可PO~但~至少我熱血過 >	joy
 从不会，慢慢学习到今天 。这是我与个月Trading的成绩 =]用正确的心态来投资外汇，让我拥有而外的收入…选择好的团队 ， 完善的平台PT0  M.O.P -Forex Invesment / Trading 如果你有兴趣跟我一起赚取额外的收入可以Pm我了解  .	joy
苦盡 甘來努力就是為了得到甜美的果實一起為未來加油^^。。聽說今天[PERSON] 度會降到00~00℃一樣要注意保暖囉!!讓我們迎接這美好的X'maxFight!!By Jason with Stephy Shih	joy
 送貨完畢太棒了切片的突然好熱賣一直都是豬肉雞肉熱賣但切片口感比較好 所以貴一些有些顧客會不捨得買切片越來越靠近新年啦趕快購買回去給家人價格公道 with Rex Chong at 凯记板面糖水铺.	joy
 祝大家新年快乐	joy
 圣诞节 - 大促销!!!新顾客 - 新优惠!!!{ 配套A }水嫩亮肤脸部护理 RM 00.00功效：锁水、保湿、美白、抗老、抗皱{ 配套B }瘦身美体护理 RM00.00功效：打散蜂窝组织、全身燃烧脂肪、休整身形、减轻体重欢迎来电预约及咨询00-0000000ANN DE BEST BEAUTY	joy
 人：不能做得太假！假了，難以交心！好友們 一起共勉吧^^~*0000.00.00 韓國大公園 索尼A000 00-000	joy
 今天最滿意的作品上部區髮色不漂調出亞麻灰棕下部區火豔紅加上外翻蓬鬆的捲度超級美店內夥伴都愛到不行米蘭使用Itely義大利進口染膏還有0天歡迎預約喲00-0000000瑞塔等你預約變髮喲	joy
左右乳房腫塊下腹墜脹感可明顯減輕，一個來月腫塊、肌瘤、[PERSON] 大面積萎縮，0~0個療程，大的腫塊肌瘤囊腫都能消失。月經不調，痛經、白帶異常也會恢復正常。	joy
 最近每天都忙年饼。。。几乎都没有好好的煮一餐，今天忍不住了。。很想好好的享用一餐自家的住家饭，虽然是简单的一餐家常便饭，我们一家都感觉好幸福哦~	joy
 第一次捐血拿那麼多獎品六罐壺底油 三盒多功能微波蒸籠 三罐果汁牛奶 六包餅乾 白人牙刷牙膏一組 沐浴乳一罐 大家快來捐血吧 感謝埔心獅子會 熱情邀約與贊助 with 吳宗翰 at 彰化縣埔心鄉立圖書館.	joy
 向各位Facebook的朋友们拜早年来咯！祝各位新年进步，身体健康，事事顺心。 .	joy
去拔掉我的智慧牙，然后叫人帮我拉脸骨！（哇，想到都痛死了，可是女人爱美的程度是很不可思议的）很开心，真的很开心！我不用捱痛就可以瘦脸了。。女人们还在犹豫吗？肥不是丑，可是肥一定有健康问题的程度。。所以一起加入健康漂亮的行列吧！	joy
Very good  今天我得到一份礼物：一盒彩色笔。 (我的国庆彩画被入选了）谢谢[PERSON] 老師，我会更加努力！ with Ken Boonsun and Tan Bee Yook.	joy
My favorite noodle! ha...  又來到我最愛的越南河粉店，等等吃飽就搞定姐姐跟外甥女的禮物，今天是0月0號星期四，到了晚上我就可以領最後一次薪水還有知道這六個月在七星級飯店瘋狂加班，假日取消，年假時數，五天國定假日這些總額飯店會給我多少薪水也就是英文說的「extra payment」 	joy
 恭喜我們這組得到釣最多尾獎~本次活動大成功~還有菜好多好多，吃到大家肚子都要爆破了怎麼還吃不完咧？!等等上班的午班同仁有口福囉！~	joy
 貴婦名媛永遠有人取而代之，唯有精品百貨的靈魂永恆不滅。貴婦名媛的璀璨繽紛天堂 ， BELLAVITA。人型比例圖是家弟 吳政澤  	joy
 這正是我們一直在做的事啊～當客人透過『均衡營養＋用心服務』得到他們想要的完美效果，甚至是開始照顧家人健康時，內心的感動真的是無法言喻！我知道，我們正在做對的事～我真的很愛，更是感謝賀寶芙！讓我們一起讓世界更健康～ with Shihche Tseng.	joy
 等下去西门丁扫货囖 我爱死台湾蜡！ in Wufenpu, Taiwan.	joy
 祝各位人日壽比南山	joy
生意 让我人生有最大的转折点 让我明白梦想是可以实现的!!!一个人一定要设定一个目标 然后不顾一切坚持往目标前进就一定成功 !!!我加入这门行业认识了更多有梦想的年轻人 每个人都在为自己努力奋斗着 !!任何事都应该去尝试了解一下 因为你无法知道 什么样的人或事 将会改变你的一生!!! with Bernard Chan	joy
Good Monday to Everyone.. Let's start our skin care journey with Oriskin Blemish Solution !Oriskin Malaysia ♥ Oriskin ♥ 现货提供~ 喵～ 好多寶貝信息我問我都用什麼保養的登登⋯我都是用這Oriskin產品的喲❤️ 我每天塗一塗 有痘痘很快就好了 美白功效是我最喜歡的!!! . ⭕️毛孔...	joy
 [PERSON] ，四物雞湯，臭豆腐，今天的晚餐	joy
 今年我們與BLOW再度合作，以「魚意」為主題設計一系列共00款時尚利是封，描繪魚兒優雅及充滿生氣的形態，象徵年年有餘。由即日起，大家可於全線的一田百貨(新蒲崗店除外)、PAGE ONE、LCX、K00 DESIGN STORE及香港．設計廊(位於香港會展中心)有售，歡迎大家選購!	joy
 RH+O 台中總公司 展示中心 即將與你們見面,在太原路二段00號,歡迎開幕期間時你們的蒞臨	joy
 感謝[PERSON] ，[PERSON] 親子童裝的衣服真的是太便宜了~~~快過年了!要為寶貝添衣服的快來找我吧  at [PERSON] 親子童裝.	joy
Lapu Sim  柔佛新山美食 那天问了大家《椰子盅》的地址，原来就在permas jaya与[PERSON] “同街”，但在最尾段的店面“新国花”咖啡店…椰子盅就在路旁摆挡口…TomYam海鲜和上汤啦啦！还多叫了一碗卤肉饭！太棒了…好新鲜的材料…还打包多一份Tomyam给朋友吃… with Lee Ann at...	joy
 今早有幸约了两位美女在爱情桥下的面档一起吃早餐突然干爸一通电话来到吃饱后我就陪同许才发先生他们等人巡视了爱情桥之后就一同来到角头壁画者之家看看…美好的早晨~	joy
不知道, 第0年自己也忘了有这个account , (直到收到GYI才想起) 给下给下已经第六年了。存钱户口就是要这样才能存到钱呀! ☆Ch'ng Jason☆ 	joy
 花生 RM00 花饼 RM00 黄梨 RM00 巧克力 RM00 杏仁 RM00 青豆 RM00 椰饼 RM00 玉米饼 RM00 麦片饼 RM00 欢迎订购。	joy
 就是今天囉~~小聲通知有毛孩子的家長們.明天活動有寵物義診和寵物義剪的服務哦!!!天氣涼爽.和家中小人兒和毛孩子一起到現場逛逛..找找BETY的攤位..做做愛心趣~有愛就有褔~感恩~^O^	joy
 有些事，做了就做了，就不去想了，再想，心会烦；有些人，走了就走了，就不要留恋了，再留，心会卑；有些情，没了就没了，就不去怀念了，再念，心会殇。要知道，做人之美，在于简约；做事之美，在于利索；胸怀之美，在于宽阔；聚散之美，在于淡泊；心情之美，在于快乐。 .	joy
 親愛的叔叔彩卷行開幕了，我剛剛沒刮到獎，可見大獎還在店裡，大家一起來發財做公益在台中市北區原子街00號唷	joy
!因著祂，貧窮的成豐富，軟弱的變剛強; 因著祂，愚昧的成智慧; 卑微的變尊榮!!因著祂，被捆綁的得自由!!因著祂，在黑暗中的人看見了大光!!因著祂，流淚谷變成泉源之地!!祝你聖誕快樂	joy
 【工作】0个小时甚至更多都卖给老板＝月光族【创业】需要大笔资金时间&健康都赔上了＝有钱但没时间【失业中】天天在家上网看戏&玩游戏＝无聊又没钱【寻找肯给自己一个机会的人】【条件】男女皆可+00岁以上（尤其家庭主妇更要注意）免费报名网址>> ★注册后请常收信★兼职 全职 自由工作者★ ...	joy
 吃饱饱啦~ Jw Chin你等我啊~我走完pavillion就过去了  	joy
”中年女人一下子瘫坐在长椅上。 她如果知道是总裁先生就一定不会做这无理的事，可她做了:只不过在园丁身份的总裁面前做的!为什么?是因为身份高低?尊重每个人，不以身份而区分:这是你的风度，风度是装不出来的，总要露出真实的!	joy
I use our Satin hand scrub for bath!  影响你们的胃口真的很抱歉~嘻嘻！！但是实在太棒了，真的要分享一下。这是我特地几个星期不做护理，让我的脚干巴巴，然后用玫琳凯的护手系列，把我的脚‘焕然一新’。不信可以来试试，一次见效，联络我。	joy
 下班了,路過0一00，被別人手上的雙淇淋吸引，管它熱量高！就買一支嚐鮮囉！	joy
Daisy MANG [PERSON] 【PAN ASIA】~ Portrait｜Actress｜EMCEE  不足0小時的睡眠，眼睛有點腫腫，嗓子有點癢癢，繼續開工啦。	joy
JuNo ^0^  每天早上再怎麼豬在被窩裡，到了時間都一定要堅持起身泡了一杯牛奶給妳再說..Fighting Fighting希望大家每天都要開開心心的❤️ with MelodyMirabelle 'мм and Melody Teo.	joy
 回嘉的感覺真好 <0遠離繁忙的台北，享受悠閒的鄉下生活。 with 陳怡璇 at 嘉義縣水上鄉下寮村.	joy
Our AgeLOC product is so effective until u cant resist it  透过NuSkin~ 妈妈一样可以站在大学生的儿子旁边，变成女朋友会吃醋的「女朋友」。	joy
（妳）購物愉快^＿^ ps:一起把這消息分享給更多人知道吧p^_^q at 全聯福利中心善化中正店	joy
/user/index00.php?s=joinaudio電子信箱：et.netLINE ID：joinaudio (可詢問報價及觀看最新產品開箱動態)【主要經營項目】經銷 High-End 及 Hi-Fi 音響設備經銷各廠牌[PERSON] 及投影機經銷品牌耳機及各類線材日本 BS 衛星及數位機上盒申裝劇院及舞台音響設備專業多媒體視聽工程及專業維修Sony 嘉義特約展售店 with 蔡坤成 and Mo...	joy
Happy to please.  Friends from Taiwan & Szechuan at KB Beef Noodles (Restoran KH00, Puchong Jaya) yesterday. 感恩有机会让我带来自台湾和四川的朋友尝尝我妈妈的牛肉面。他们赞不绝口～我们三种不同的华人在此交流、切磋不同国家的特色与文化。我昨日真的是大开眼界丫！ with Yin-bai...	joy
 又是年初九天公诞的日子，祝贺福建人新年快乐。发呀。	joy
 祝福小妞兒們聖誕節快樂「快樂時尚」抽福袋活動開始囉☕小零嘴光療凝膠 指甲彩繪 手/足SPA護理小野 美甲師TEL：0000000000LINE:(ID:0000000000)新北市土城區延和路000號（HAPPY HAIR） at 快樂時尚藝術美甲（土城）.	joy
：00-000 0000无上甚深微妙法， 百千万劫难遭遇 ，我今见闻得受持 ，愿解如来真实意。欢迎大家一起出席共沾法喜， 感恩。南无阿弥陀佛_/\_  at 槟城净宗学会	joy
，拌打至硬性发泡，加入（C)拌匀0）将（0）放入已装入花嘴的挤袋里，挤在烘盘上0）放入预热烤箱，一000度烘0个小时至干身即可 	joy
Have a nice trip  日本東京五日行！ with 陳柏安 at 臺灣桃園國際機場第二航廈出境大廳.	joy
 [PERSON] 和我加拿大回港表哥一家人，在市區吃豐富晚餐聯誼當中！ at 六榕仙館. 齊來做義工，行義我關懷！	joy
 牧师，您该听到的严酷事实0.你的家庭是你的第一事工，不是第二。0.你永远不会掌控一切的。0.除了你的配偶，你还需要有人在你的生活中，知道你的黯淡面。0.你的脚步往往决定你的长度。0.你不是唯一一个精明能干的。0.没有你，你的教会依然进行。0.你干得比你想象中的好。 	joy
 福星高照 心想事成 <0	joy
琳日韓精品館 好讚 ) ✔0、留言處標籤朋友0～0位 ✔★已完成三項步驟即可參加活動★活動結束後將抽出0位幸運兒送出抱枕★活動時間0000/00/00～0000/00/00社團：： kitty0000000 with 呂芷葇...	joy
 0.遇到挑戰別急着解決，先學會面對和分析！0.遵守信用，言出必行，贏得人們的信任！0.做自己，讓別人明顯感到你的氣場！0.打心底尊重每一個人，無論他們地位如何！0.保持敏銳嗅覺，不斷學習磨練自己，讓你的能力高於常人！	joy
Welcome everybody n Happy Wednesday to all lovely friends...  hello 大家好！ 請加入以下這個溫馨有趣的小家庭如您想和我們一起共同歡樂、分享及享受等等。～ 歡迎您加入：-「[PERSON] 歌友俱樂部」噢！- 您只需要輸入： ～ 葉鉦汶	joy
Pinkey紐西蘭聯絡0000000000,line ID:pinkeychao-bianca  即日起跟粉紅姐租車JUCY or APEX,我會免費提供汽車Gps和行動電話的充電器。讓您在紐西蘭旅遊不用擔心行動電話或小筆電沒電。	joy
参与我们家连家的手工活动，请每逢星期二早上00点来[PERSON] 医生诊所的楼上报到，我们会有APPLE老师免费教大家烹饪和美工的技巧哦！！ 	joy
 [PERSON] 家每年初三的家族聚會都會回來上百位親友，不論你是剛出生、大老闆，還是在海外，通通都要回來團圓，所以我們家都很親，也很團結。 at 雲林縣麥寮鄉興華村長宅.	joy
Yun [PERSON]  今天外拍，意外的發現有一台飛機停在旁邊 with Yun Chao at 琴佳諾風格攝影工作室.	joy
 愛在屏東 立法委員蘇清泉暨縣議員[PERSON] 服務團隊恭喜玉璇獲得大仁科技大學學業成績第一名創業講座及規劃設計第二名[PERSON] 在地服務創意佳作[PERSON] 咖啡網路行銷第一名我們以妳為榮!	joy
 阿諾抱著豆豆開心玩挖土機	joy
 台北新車大展❤Land Rover歡迎找我拍照〜今天投票了嗎？下載APP每日投票給我唷（＾∇＾）0號劉秀慈Ruby謝謝大家〜❤❤❤ at 世貿一館 / 台北世界貿易中心.	joy
Bro~~ Your bday gift.. This one right!?!? XD  來了，來了，經典沛納海000來了	joy
，哈雷路亞，以馬內利⋯❤❤❤❤  	joy
 今天的	joy
，按0号（Basic ，0个小时）选颜色和大小再按Start面包机就开始工作。******Tesco 面包机做法：调时间～把全部材料倒入面包机（液體先放粉类放上），按0号和选好颜色和大小（选Light colour，0.0LB。）时间就调妳要几点做好~比如你00点睡面包要0点烤好妳就把时间调去0小时然后按Start面包机就会开始倒数，睡醒就有新鲜面包吃啦! ...	joy
miss this day with Nelly Sim  采云，谢谢你这么了解我。。。我也很感谢你带 给我这么多的欢乐和微笑。无论你身在何处我都会默默地为你祈祷。我希望你能够开开心心 ， 平平安安地过日子。请你一定要记得我永远是都是你的好朋友。 with Chai Yuin Leong.	joy
 這幾餐每餐都喝酒⋯⋯黑棗酒，紅酒，人參酒，竹葉青，格蘭菲迪00年，Whisky coke⋯⋯⋯—_— .	joy
[PERSON] cafe  午後的悠閒 Thanks. 我的愛人 	joy
， 留言告诉我，你想要 lifeline 牛初乳 还是 SD0就那么简单！！！	joy
 [PERSON] 0個月嘍～	joy
 晴天里有阳光阳光总是充满温馨相信有这么多朋友的厚爱和鼓励 晴天会永远阳光灿烂一场飘雨后阳光带着清醒的空气飞来试问是哪位仙子的生日阳光如此的美丽朋友们，晚上好，新年的阳光带給你们永远幸福快乐。。。	joy
 来来来，大家可以帮忙吗？我的表嫂的cafe即将在pandan malim开张（在old taste 对面）。所以请大家多多支持！xD有tag到的，请帮忙share出去，让更多人支持。 .	joy
 MyKuali：槟城白咖哩面 这个即时面真的不得了~它被选为全球00大辣麵排名第七的全世界十大拉面之一小包装中有0小包的调味包：一个是特制辣椒酱（灵魂）一个脱脂奶粉一个味精这可是槟城的品牌 工厂是在大山脚 喜欢辣辣的你，一定要试试 不可错过呐 超赞♥♥还等什么 赶快pm吧 :) 	joy
 春节到拜年要趁早:一拜全家好二拜困难少三拜烦恼消四拜不变老 五拜儿女孝六拜幸福绕七拜忧愁抛八拜收入高 九拜平安罩 十拜乐逍遥 谨贺马年好健康没烦恼除夕快樂^_^ . 快樂，是我們每個人都想得到的無論是誰都想每天快樂的生活，快樂的工作，快樂的學習，擁有一個好的心情。若想擁有它，其實並不難，要順其自然，不必去強求 、去等待只要積極的去創造...	joy
还好意思不爱你老婆？ 0、老婆在娘家都是被父母宠着，来了你家还得看你老爸老妈的脸色做事，你好意思么？ 终上所诉，同意的女同胞们看了要转发，让更多的男人明白怎么对老婆！！！这个我同意！！	joy
 梁粉们，明天会见到你吗？倒数还有0天！明天就是《爱FM。爱是一家过马年。DJ见面会》啦！我准备好了，明天（00/00）下午0点，约定大家在吉隆坡金河广场底层大厅，我们不见不散！（首000位到场听众可以获取爱FM0000年精美台历/贺岁专辑CD哦！号码牌将在下午0点派发）	joy
工人工資的錢，剩下的錢還比窮人賺的錢多了幾倍。一個月很快過去了，窮人只挖了煤山的一角，每天賺來的錢都買了好吃好喝，基本上沒有剩餘。而富人早就指揮工人挖光了煤山，賺了不少的錢，他用這些錢投資做起了買賣，很快的又成為了富人！結果可想而知，窮人再也不抱怨。觀念決定命運，想法決定活法。	joy
Pm me for further details on  为了开发更广大的市场，现在招收代理，批发 和零售。。。请留言给我。。。海外的代理也欢迎。。。来自Switzerland 的Swiss Apple Stem cell 已经是其中一个我最好的介绍和卖的产品。。。	joy
從加入招待團隊開始吧！ 	joy
Stock Clearance! Purchase today!  可爱韩版长袖衣0 现货! 免邮! 今天就购买!=) .	joy
 知道我想要 就买了送我 谢谢你的礼物❤️ with JunMing Lim.	joy
 Happy CNY! Happy Birthday!!..我Alfred Tan在这裡共祝大家。。事事如意, 身体安康,一本万利。。Longrich事业马力全开。。马上行动。。马到功成。。。人日生日快乐!!!♡♡♡	joy
 嘿～嘿～身體香香外果然一整個浴室狠給力的⋯香、香、香～ with Chiayun Hsu and Yi Chen Hsieh.	joy
 Rapibust说明效果视频：  (购买前欢迎点击以了解更多这个产品哦～～ )亲亲们〜看了你们一定会购买吖 很值得 也会让你很惊喜〜这也是我补货第三批了相信很快又会被一扫而空吖 .	joy
Good morning world! !  一个懂你的人，能带来一段彼此舒服的爱。一个不懂你的人，最终会让你懂得一个道理：人生中，懂，比爱，更重要。Good Morning !	joy
Have a nice trip  出走充電… at 香港國際機場 Hong Kong International Airport.	joy
 超夯熱賣的～紅花油精華膠囊～缺貨了～預計明年0月0日到貨～現在預購享有最低優惠哦！貨到會先以下單匯款的人出貨哦！ Tonalin®[PERSON] 純紅花,共軛亞麻油酸是人體所必需的脂肪酸,可促進能量的新陳代謝~燃燒脂肪～配合運動有助於輕盈窈窕～  保證公司貨～喜歡可詢問～優惠中～	joy
 亲爱的, 只剩下以下的两盒«LEADERS INSOLUTION» masks。如果想要的话就赶快给我知道。谢谢哦。* Vita Bright ×0 boxes(for brightens & even skin tone)	joy
 难得的团圆饭 .	joy
Q good morning  嘿嘿“ 人生本来就是一埸赌局“ 不赌不知道” 谁输赢“ 没有人想输“ 但输要输的漂亮” 赢要赢的精彩。	joy
Well done～ <0  0000金视奖 十强名单公布啦！[PERSON] 有幸入围最佳男配角 [PERSON] ！！恭喜所有入围者，Good Luck！！！ with PuieHeng Chen [PERSON] .	joy
 [PERSON] 也有Ic马来西亚真的很行	joy
faster faster go....haha..government giv money liao...  巴生人 是selangor baby就 快快去申请和拿罢。。。goverment给的我们就要拿罢了。。	joy
 現在服務處也是青山國小的愛心服務站囉，未來小朋友在路上碰到危險或是發生事情都可以來尋求協助，其實只要有需要幫忙的，都可以到服務處來找我啦！	joy
 每件事情都有它的門檻、也有它的成本思考選擇需要時間、參與遊戲該具備資源提高勝率要資訊、整合高端人物須要籌碼外在可以爭取而--- 勇氣與決心，要自己給。	joy
 有要看高空煙火的朋友注意囉……土城鹿耳門聖母廟高空煙火在農曆初九舉行喔……(國曆)二月八日	joy
 北院【非以總統府為犯罪對象就需羈押！】重賞檢查官和高院五巴掌 水啦！	joy
拍不出的真實美景。當別人忙著透過鏡頭記錄這一個moment，我用眼睛記下更真實的世界。我回來啦 Buffalo.	joy
 秋山居的第一場婚禮溫馨且隆重，在大家的祝福之下、新人認真仔細的在誓言証書上印下屬於一輩子的幸福…祝福你們“要一直幸福 at 國姓秋山居山莊.	joy
 《仁》爱广度，致富财路。《义》浓深度，官运坦途。《礼》贤力度，人生贤助。《智》慧高度，快乐永驻。《信》誉诚度，幸福无数。五句箴言，新年祝福！年初二獲福得福！ .	joy
 響應捐血活動天冷大家不習慣出門捐血的人變少了但需要血液輸送的朋友仍很多快挽起袖子一起熱血吧！ with 陳文揚 at 苗栗捐血中心.	joy
，  高雄災區居民到高雄劉江便當用餐免費、馮身份証即可、幫忙宣傳謝謝[PERSON] 江店。新富店。五甲店。 . ~~	joy
,所有權經轉換以後,買方也必須參與都更,不得中途退出,藉以保障都更者的權利.	joy
與此作侶？吾今為欲斷諸苦故，而來至此。苦若斷時，然後當與一切眾生，而作伴侶。」悉達多太子所示現的，正是為修行而出家的僧人們應發起的弘願。 in Lumbini, Nepal	joy
與和尚論茶道。和尚道：色不異空，空即是色。茶人道：水不是茶，茶就是水。和尚道：老實念佛證菩提。茶人道：用心泡茶得真味。和尚道：明心見性，度化眾生，是佛陀。茶人道：遇水捨己，濟人無數，為茶飲。和尚道：心就是佛。茶人道：佛就是水。...轉載...	joy
 沅沅宝贝,生日快乐!  	joy
 馬上贏錢生日蛋糕00吋000元。00吋0000元。宅配請加低溫運費000元。貨到付款請加00元手續費。請於0個工作天前預訂。訂購請私訊或直接來電：00-000-0000麥田金造型蛋糕 at 麥田金低糖健康烘焙坊. 盧小姐訂的喵掌蛋糕	joy
 好多漂亮俏麻咪推薦 ～✌不用出門也可以洗照片 超方便的下載APP（幸福小[PERSON] ）而且照片材質好讚喔～好喜歡 ☺他們好好喔 還多送0張月份給我 ❤  .	joy
 准备登机中... 宝贝好友们.. 要离开大家几天； 准备到[PERSON] .. 好好放鬆一下.... 那里不知道fb可不可以用.. 宝贝们要想我喔... at 桃园国际机场.	joy
 黄财神~是藏传佛教各大教派普遍供养的五姓财神之一,黄财神为北方司财众部之首，掌诸宝库,可获其庇佑能财源广进，免除穷困，以及一切经济窘困。 {黄财神佛像00“，全金，于克切拉天堂文物店，  } .	joy
 朋友今年尾牙獎品----Bottega Veneta (BV Duffel)黑色大行李袋。據實際觀察較適合男性提拿(中性款)，原價七萬六千八百元整。 至少原價的七折，價格可議。請各位親朋好友，如有任何人喜歡這款請盡情的與我聯絡，並幫忙轉售，謝謝。 請私訊實際價格$$$$面交免運費!!!! with Dora Chen.	joy
下去）讓一位不是佛教徒的父親與佛法結了緣也希望三寶慈悲加持祝福那位父親在之後的生活能夠平安順遂這件事情在我的生命中是一件印象很深刻而且也很感動的事情	joy
ken Betty Dance Ken  今天當翻译！Karen 大课[强][强][强] Samba the most diffculties dance! 再次強调rhythm 節奏的重要性！如何識别和区分已至運用0種全统節奏和0種新節奏！作为一個冠军舞者努力，積極和善用智慧是必须的！[强][强] with Karen Hardy.	joy
 親愛的朋友們~在這向您們拜個早年駿馬奔騰來報喜，萬事順心又如意在新的一年前 抽個好牌好過年...元月00日(星期二)00：00~00：00至壹辦啡 北斗店消費一次 即可免費抽好牌 問塔羅喔!!!請專業大師 賽[PERSON] 為您解答祝願來年河清海晏時和歲豐好友們志業順展馬到成功!!!  at 壹咖啡北斗店.	joy
 TRC騎士論壇特約卡真好用，免費招待餐前酒兩份。 at 台南市安平店西堤牛排.	joy
 Melinda的粉紅花園～  at 【彰化溪洲公園】.	joy
U can do tt too  真的很想很羡慕那些很潇洒放下一切的背包客❤	joy
 快來報名全期0000游泳春季班!!! 誠心獻上限量嚴選唭哩岸YMCA優質精品保溫瓶!!! 請大家告訴大家!!! 	joy
Awesome!!!!!  你們知道*無動物實驗*的重要嗎?有些[PERSON] 小孩們一出生就不能接受正常的生活正常的爸媽關愛必需為了人類犧牲我們理想家產品就是能不動物實驗就不動物實驗。因為用最天然的東西所以無需動物時驗研究人類就能安心使用。 with 楊涴柔.	joy
可能這麼順遂？NBA這一連串的意外與挑戰，是書豪的試煉。勇敢的他接受、享受能上場的時刻，非刻意繞路而行。身為豪迷的我，不應該悲觀來看這一切，而遺忘了書豪給我正面的強大能量！現在，我只想好好的欣賞他上場的每一刻，其他的，不在強求。	joy
 祝大家~新年快乐！天天好天！ with Kelly Kee.	joy
 一個禮拜前就打算拍這張照片了剛好利用今天回家的時間拍起來。這家從我國中至今有好多回憶也給了溫暖安全的避風港每次只要回來身心就會放鬆所有壓力即刻消除多少次的抵擋狂風暴雨多少次的抗拒數次地震也...多少次的使我們全家團聚多少次的使我們全家歡樂好多好多溫馨的回憶因家而在好多好多溫暖的依靠因家而在 家永遠都歡迎你回來謝謝家~	joy
谢谢大家的支持!谢谢你们	joy
All good  愛不是控制 而是學會包容及尊重不同的意見和做法。給彼此的空間越大 距離才會更近 祝親愛的好友假日歡樂順心 平安吉祥卍	joy
 早安 ＾Ｏ＾☆♪	joy
Chia Sengchong Jeremy Liew go apply =D  巴生人 是selangor baby就 快快去申请和拿罢。。。goverment给的我们就要拿罢了。。	joy
 這樣的美拉其實還滿有氣質的 哈哈攝影: Jay Lee 個人寫真 婚禮記錄 活動拍攝 夜店拍攝 場地: 大盛數位攝影公司麻豆: 范美拉  at 大盛數位攝影公司.	joy
 今晚係我告別演出	joy
 今天確實冷，來杯熱茶啊：）杯空香氣來，心空福祿至。圖：[PERSON] 	joy
 沒錯，我家老三等不及爸爸媽媽幫他挑的日子，自己決定提早來報到囉！000/00/00  祥軒.	joy
，要把口封好，不然煎时肉汁会流失先把不沾底的平底锅烧热加入冷油（不需要很多），把包放入锅内，转中火让它煎一下，再加 0汤匙水盖上锅盖让它煎到干水，然后把另一面煎到金黄色就可以起锅了！！香喷喷的咸鱼包是超赞的点心。。一定要趁热吃才会有爆汁的感觉。。如果不要马上吃，我建议把包好的包子放入冰箱，要吃时才煎。。 祝大家成功啦。。。。	joy
 大家去年宵記得去M00幫襯下 .	joy
 ; 这双就是我的新校鞋 <0大爱 <0 <0 converse :0#班级名表更新了没有 #紧张	joy
控制.煮粥、煲汤全自动.盖盖子不会溢.最长预约00小时.还可做酸奶、蛋糕唷! 	joy
佛言佛语 在修行学佛的道路,一路上一定会有遇到甚多的崎岖坎坷,牛鬼蛇神,我不是一个很努力精进的佛弟子,学佛的过程遇见的种种障碍和磨练,它们反而成就了我的心愿,加强了我的心智,增长了我的智慧,感恩,阿弥陀佛。。。一月二十二日二零一四年。。。	joy
Loi Yong, u really cute lehhhh...  MCD 代言人 .	joy
❤❤❤❤❤  投捕搭檔最後的合照以後要見面就很難了希望你可以在輔大闖出自己的一片天不管在哪裡 做什麼事都可以不要放棄 加油啦 兄弟 永遠支持你	joy
Ready Stock !  0套现货到了，快来pm询问哦！	joy
 在[PERSON] 老师家^_^	joy
Alex 力进 Dun miss out...!!!  喜欢唱歌的朋友!! 不要错过这个机会咯!!	joy
 新年快乐 风调雨顺, 事事顺 万事吉祥, 人事顺 富贵满满, 财运顺生意兴隆, 百事顺 吉星高照, 万事顺祝我的朋友们,全家平安,健康,幸福,喜乐♡	joy
Feb-00 暂停共修 00天。祝福大家『新年快乐，六时吉祥，福慧圆满，阿弥陀佛』**暂停共修日期可能会更改（缩短） subject to change! 将另行通知。南无阿弥陀佛_/\_  at 槟城净宗学会	joy
 最近才認識蒟[PERSON] 新產品，聽說熱量低～還不錯吃！	joy
 身体健康，生活才会有质量多。多数人是失意时、咽气前才懂！世界上到底什么是你的，这个问题可能有好多的人想弄清楚。身体健康，生命就会长。没有了健康的身体，就没有了生命。没有了生命，一切就都不是你的了。所以我们只要活着一天，就是福气，就该珍惜。改善健康就从自己开始，这样才有能力照顾身边最亲的人PM 我吧 !!!	joy
Congratulation to Tee Kok Tsun from Sabah.  “等了那么久，我终于上了今日星洲日报的新闻…”	joy
相增加招財效果。也混合Poom Phai意思是骨灰粉，0方坟墓土一起制作来增强皮鲁的效力等等，有興趣的不要錯過。预定价格不高要的人要快了，过了预定期价格就不是那样了预定时间为两个星期00/00/0000--- 00/00/0000要的大家请留言哦！ 	joy
 中山五顯宮_五顯大帝 at 五顯宮.	joy
 衝日出^_^ 雖然沒見到傳說中的紅日，但有像畫一般的湖面相伴------------------------------------不管發生了什麼事，世界依然不會停止轉動，是吧？拾起微笑繼續享受人生 with 佘英列 and [PERSON] 	joy
Yes for Bintulu....Yes for Sarawak...  两位马来小朋友参加 0000年全国学艺比赛 (民都鲁区选拔赛)。这也体验出一个马来西亚的精神，发扬中华文化。	joy
度00分钟— 	joy
 好朋友定義：開心地吃一餐朋友團年關年飯，大胃口病毒互相感染，四個人食十三樣野，愈食愈開心，價錢沒有理會，不停重覆“叫啦”、“叫囉”，叫到一枱都係都冇問題，因為大家都有份食落肚，大家都有份叫，一滴都冇嘥yeahyeahyeah,！ .	joy
。小朋友写：先生，再见!老师批语：想像力超过了地球人的智慧。00.题目：况且小朋友 写：一列火车经过，[PERSON] 且况且况且况且况老师批语：我死了算了。。。 	joy
 在家閒閒，想到那些在冰箱躺了粉久又酸到閃尿的奇異果，鎖性將它們拿來剁了，再下鍋狠狠的熬，結果真的被我熬成醬了，第一次手工自製奇異果醬，裝瓶剩在鍋邊的撈一撈加個紅茶包沖泡變ㄧ杯水果茶，也很讚ㄋㄟ	joy
分钟完成 ^-^	joy
 全老爹送的生日禮物！像嗎！哈哈	joy
细胞，调节体内结构，达到排毒养颜，防止水肿，腹胀，去除有害的自由基。适合：消化不良者，免疫功能低者，工作压力者，水肿者，肉食者，熬夜者，超重肥胖者，便秘者，曾经或者吃着瘦身产品者 with Agnes Chua	joy
 祝福大家冬至快樂在愛人身邊團圓幸福哦	joy
成就一切 而改變只要一分鐘 歡迎填寫索取資料如果你是发自内心的想,免费了解>>  	joy
ㄥ  我們來到了[PERSON] 的拍攝場景其中一幕，看過許多巨石,但這是第一次看到是圓的巨石，據說這是恐龍的蛋真的很特別!! 	joy
 一个人最少要在感情上失恋一次，在事业上失败一次，在选择上失误一次，才能真正的长大。亲爱的，别怕输不起，一切来得及	joy
0位。按讚破 00000、分享破 000：抽0位。按讚破 00000、分享破 000：抽00位。※得獎人如封面照有更換成 水巫小雪新封面，則再加送一張小雪簽名拍立得。※ with 莊詠惠 and Winnie Chuang. WINNIE.SNOW:+LIFE...	joy
 祝大家~人日快乐♡合家团圆♡心想事成♡身体安康♡横财就手♡	joy
 爸爸煮的好吃牛肉麵	joy
 在云顶的雪屋拍的,赞个吧	joy
Good  好友们：早安愉快，不管是好缘，还是恶缘。我们都要勇敢面对。难得今生缘分来一起吵吵闹闹又开开心心快快乐乐的过每一天。幸福死了。。(*^__^*) 嘻嘻……	joy
 [PERSON] 迎新春 拍摄桃色大片 《私人订制》[PERSON] 主演《私人订制》正火热公映，电影票房已轻松破0亿。[PERSON] 片中的造型也获网友认可。近日，其全新迎春大片曝光，桃色当道，美艳动人。	joy
very good bring me same  我的面包来咯！初次做面包的我觉得时间好漫长哟.．总算大功告成，哈！哈哈！ . 做蛋糕	joy
Special Promo For Ladies!! HURRY UP!!  MOMO特别为母亲节推出母亲节特别促销！高达 [PERSON] 的折扣！让妈妈与女性朋友们享受我的高级精油SPA手脚护理（原价RM000）！如要预约请联系 00-0000000 / 00-0000000.  	joy
 ╔══╗ ╚╗╔╝♫(¯`••´¯).(¯`••´¯) ╔╝.(¯`••´¯).¸.•*❤*•.¸.•*(¯`••´­­­­­­­­­­­­­­¯) ╚══*•.¸.•* .... ԼƠVЄ.... *•.¸.•*❤ ƴoƲ ♡♡ ＭＩＣＨＡＥＬＪＡＣＫＳＯＮ ♡♡ .	joy
身體有點回復啦~(現在席開第0攤粗火鍋啦~隱藏+0個我的最愛麻糬們~呀比耶~)	joy
stay tuned :0  MX ACADEMY 今年是第三年了。。0月份将是我们的周年纪念。。新娘课程，新娘发型课程，专业课程都有大offer....不要错过	joy
 今天的太陽好溫暖<0	joy
Edmond Lam  【有时间坐列车去旅行：北京→ 莫斯科】世界上最长的铁路，每周三从北京站发车。六天六夜的旅途,要耐得住旅途寂寞；穿越西伯利亚大陆的时候,沿途全是大森林大草原,风景壮丽无比；当然也能找个伴儿一起体验这非同寻常的旅行。你所做的不是犹豫而是走出去。 .	joy
Amituofo.  ＂感恩＂時時付出，時時歡喜，時時感恩，時時有福，有感恩心就沒有敵人。 .	joy
^^  馬上贏錢生日蛋糕00吋000元。00吋0000元。宅配請加低溫運費000元。貨到付款請加00元手續費。請於0個工作天前預訂。訂購請私訊或直接來電：00-000-0000麥田金造型蛋糕 at 麥田金低糖健康烘焙坊. 盧小姐訂的喵掌蛋糕	joy
 記得唷 ~服務處舉辦迎春揮毫免費送春聯活動 (-^〇^-)歡迎民眾一起共襄盛舉~ 一起迎新春唷!!!0月00日(六) 早上0:00~00:00鳳山區勝利路 中正國小 大們前0月00日(六) 下午00:00~00:00鳳西國中旁五權南路黃昏市場0月00日(日) 中午00:00~00:00 五甲 家樂福大賣場正門口	joy
走吧!别老说自家的老婆会花钱，羡慕别人家的老婆会省钱，会过日子，养土鸭跟养天鹅的成本能一样吗？❤️❤️❤️	joy
New Life likes as colorful...  每一天，每一年，每一個人被這些抗生素侵蝕了多少健康? 多少銀子? 卻換得到的是更多病痛…值得嗎?要健康，人生才會是彩色的，也才會更亮麗喔！給想要彩色，亮麗人生的您諮詢! at 高雄榮民總醫院.	joy
 航空几号呢？	joy
 ……台中市的秋紅谷公園已經是知名景點了……它的旁邊不遠處……就有（賞櫻私房景點）……有時候身旁就有令人驚艷的好風景……朋友……找找看……你的私房景點在那裡呢？？	joy
 00:00吃完除夕團圓飯 大家又各自回巢了弟弟跟他的小孩 對我說外星要來的消息傳很久了 哈哈哈 至少還有接觸一些 我跟他們打賭 銀行關門十四天的事情遠通退租 大弟沒啥反應 二弟會退 耶	joy
 親愛的朋友早安(^(エ)^)，今天又是美好的一天，時時保持好心情，天天都是幸福日↖(^ω^)↗ at 珍典生活廚坊鳳山青年店.	joy
 只坐两个人的车太舒服了	joy
 原来上个厕所也可以遇到歌星! with Nicole.	joy
。属狗0000年幸运色生肖属狗的人0000年幸运颜色为褐色、灰色、米黄色、红色、白色。0000年忌讳颜色为绿色、青色、蓝色。属猪0000年幸运色 属猪的人0000年的幸运颜色是白色、黑色、蓝色、灰色，忌讳颜色为红色、橙色、黄色。 	joy
(⊙o⊙)！……  人一简单就快乐，一世故就变老。保持一颗年轻的心，做个简单的人，享受阳光和温暖。生活就应当如此。	joy
你演的是Harry的小時候,這次在Three Days裡要演有天的小時候,還滿有緣的)#[PERSON] 新劇三天大發#	joy
 叮叮噹……到處都可看到聖誕裝飾，一年之中就屬聖誕節最有氣氛了，聖誕節快來到了哦，大人小孩都期待著……準備好要交換禮物了嗎？	joy
 虽然我们course只有00个人可是因为有你们 , 我的大学生活很精彩 :DDiploma in Journalism ♥Fight for Final ♥  	joy
beautiful  手機像 Phonegraphy 今日日落0000.0.00＼(^o^)／	joy
拼搏一把，成為父母的驕傲呢？或許我們覺得父母給予我們的不夠多，請記住，那已經是他們的全部了！據統計[PERSON] 的孩子看完這篇文章轉給了父母，[PERSON] 的爸爸看完這篇文章轉到了朋友圈， [PERSON] 的媽媽轉發給了老公！	joy
 很有愛心的一對夫妻、請告知有需要的人不需證明文件~	joy
✌️  000000 CNBLUE全員參與《Running Man》演出!!!!!!預計0月00日放送~~~(圖片來源詳見logo)太興奮了~~~回歸在即!!!終於等到他們一起去跑跑男了~(拭淚)我期待這集的放送~~~~~~~耶!!!!!!!!! with Mitha Kartika and Jin Chao.	joy
、無上密中屬無上密，一生成佛的教法。法圓滿：心部、界部、口訣部中的口訣部，口訣部外、內、密、無上密中屬無上密，一生成佛的教法。依灌頂部而言沒有比此更高的灌頂。00/00 pm0:00 新北市舊譯講修林佛學中心Tel:(00) 0000-0000 張會長 	joy
Tang Xin Mien all this u eat anot? LOL  超过上百样款式让你选择～无需吨货，只需接单～一个星期下一次单～享有fight target 奖励～招收大量（有网卖经验）代理wechat ：abc00000000xiiaoyiyi .	joy
 0000年来了，不管世界是否末日，我们都要许下心愿，不管明天遭遇什么困难，今天都要许下心愿。来吧，在元旦这天，许下你的心愿，等待愿望实现。	joy
 盒妳一起過聖誕 00萬粉絲讚出來!! 我的第一隻Samsung note0櫻花粉，對它的愛無法言語有了你讓我的生活不在單調...以後的日子裡我會更加的愛護你...我的note0櫻花粉	joy
 #法輪大法大專學生研習營的工作人員早上一起晨煉五套功法 at 交通大學.	joy
 同時做到[PERSON] ，修護，保溼 給予完整的鎮定舒緩00分鐘瞬間喚回水亮肌膚 緊急解除肌膚缺水水水們快一起購入立馬試試看~~(︶｡︶✽) .	joy
 朋友阿。 一直窩在家裡怎麼能促進經濟發展呢！ 快出來花錢吧～ 兩個美食記者報給你。 兩人吃到沒辦法拼完照片～：）川味牛腱、灌湯飽、咖哩拼盤、水晶鮮蝦餃、鮮蝦韭菜餃、蘿蔔糕、西杏沙拉蝦、臘味飯、豆沙芝麻球、冰火波蘿油、絲襪奶茶。 with Cherie Huang at 安記香港茶餐廳.	joy
 哈囉~要過年囉！有人要訂購北港頂級黑金剛嗎??^_^一包000元$$電話:0000000000[PERSON] 婕外縣市宅配謝謝(需要的人也可以跟我私訊呦~)	joy
获赠0+0（☆FRUITY BUBBLE EX☆ + ☆FRUITY JUICY DETOX☆） 奖励哦！	joy
 我的蝴蝶放生計劃～～成功☺️簡單的搭配飲食、運動選擇ageLOC科技就是可以吃飽飽又瘦好好~~請大家幫我得到0000個讚唷!!!如果有想詢問得隨時歡迎~~~問了也不用錢~~~重點是能華麗大變身才是最重要的啦!!!	joy
—奔馳文化中心0/00-00 武漢光谷體育館0/0-0 台北小巨蛋0/00-00 廣州體育館0/00 新加坡室內體育館0/00-00 深圳灣體育館00/00 成都市體育中心00/0-0 高雄巨蛋00年巡迴，十個站你還在等什麼?特A的你,準備好了嗎??[PERSON] 全球後援會為您天天掌握蘇打綠十週年世界巡迴演唱會的最新消息!	joy
 用豆腐做的过年饼、感恩	joy
 0000年大年初一[PERSON] 跟大家拜年！祝大家 新年快樂Happy New Year新的一年設定新的目標期許自己越來越進步……謝謝支持我們的朋友，我們愛你們＾＾請繼續支持我們喔！也尋找想跟我們一起努力的朋友！一起朝夢想前進！耶……新年快樂 with 徐吉樟.	joy
Joan Lim  身边的朋友时常看我可以呑声下气被响雷声的音调在我面前和耳朵劈，我也可以以笑脸去谢意，可以若无其事，朋友们都赞说我的EQ高，其实不是！！！其实我知道人的心很小，装不了这么复杂的事，因为我就是简单平凡看待，从好的角度去看和想，我相信一切正能量的磁场不是你有多能干，而是从你内心发出的哪个（自然小孩子）	joy
是你！让我来帮你。 	joy
 我的梦想 	joy
 每個人身上都散發著不同的美， 每一種美都是誘人的。 任何時候學會用欣賞的眼光去看待世界， 看待你周圍的人， 你便會更坦然的面對一切。人與人之間不只有愛，還有彼此的欣賞！ 早安~ at 霞媽麵館.	joy
 挑戰雙腳步行到竹圍魚港 … 走了約00公里，0.0小時， 到復興航空麵包。今天太陽公公真露臉啊~ 走的好………熱。	joy
 美白新的代言人	joy
具有怯火清涼作用，能滋潤咽喉消除咽喉腫脹，改善呼吸道循環。將蜂蜜塗於燙傷皮膚處，可減輕疼痛，有助於傷口愈合。惟有多了解 喝蜂蜜水的好處 ，才能更好的達到養生保健的目的，特別是女性朋友，可經常喝蜂蜜水可有效地抗衰老。	joy
Yvonne Lee  打开心窗，让阳光进来凡是你抗拒的，都会持续。因为当你抗拒某件事或情绪时，你会聚焦在那情绪或事上，这样就被赋予了更多能量，它就变得更强大了。负面情绪就像黑暗无法驱赶，唯一能做的，就是带进光来。喜悦是消融负面情绪最好的光。 . What is a kiss?A kiss is an upperpreparation for...	joy
.seventeen.com.tw/html/ac/00.aspx?num=00&kind=000/0 台中-聖地棚拍(早場)  桃園神社-浴衣主題外拍(早場) with Yi-Ting Jiang	joy
 朋友們~大家早安哦!!!雖然才星期二而以 還是要保持好心情唷^^期待美美的假日來臨...衝衝衝啦!!0000.00.00 南怡島. Korea 索尼 A000 00-000	joy
水，将发好的喜粄放入，用中火蒸00-00分钟即可*温馨提示*~打开锅盖时，要小心别让锅盖的水滴到哦，滴到就不美了~记得别发酵过度，发酵过度皮就会皱皱的By： Yong Swee Ha 	joy
 [PERSON] 完啦！上班囉小編：台灣民政府是循國際法律途徑控贏美國政府的美國司法保護的戰爭佔領下的民政府組織或單位，目的結束中國流亡政府在台佔領，讓台灣國際地位正常化，主要佔領權國美國軍事政府，需重返日本台灣佔領，並成立台灣當地的民政府。台灣人才不會繼續被流亡的中國人偽政府糟蹋。	joy
还是便宜就对了~Etude house, It's Skin, Natural Republic 等等等等 附上照片跟货号PM过后会告诉你价钱 * :D with BiBi Lin	joy
 病尚未痊愈，新年还没到…就有种想把它们都吞了的冲动~ with Chris Ng.	joy
电话卡的赚钱计划有兴趣请PM我～ . 0000 0000000 david ng...	joy
！事实胜于雄辩，欢迎PM了解详情~	joy
 品茶心情小語人生的道路上偶而停下腳步.向後看昨日以前的我.得到[PERSON] 以對向前看.未來的你須要什麼學習心面對.樣樣無限可能心寬不會傷人.心念不純傷己.	joy
Let's Zumba!  你们有时常大量排汗吗？抽出时间和我一起动起来…一起汗流浃背⋯inbox我吧星期一 0：00pm0：00pm星期三 早上0：00am0：00pm . ^^><^^	joy
 阿里山小火車復駛通車典禮 with Chiying Chou at 竹崎車站.	joy
種豁然開朗的感覺。還沒有看過的朋友，不妨去欣賞一下囉～	joy
Kim lee  有—个鸡蛋，非常天真的和石头在一起，磕磕碰碰，把自己弄的伤痕累累。但，鸡蛋—直坚持着终于有—天，鸡蛋受不了呢，离开了石头，后来，鸡蛋遇到了棉花，棉花对鸡蛋的每—个拥抱，都是那么的温暖，鸡蛋这才明白，不是努力坚持和忍耐，就能换的轻松幸福。不管你有多优秀，也得碰到识货的人，还能遇上将心比心的人	joy
 在亲戚家拜年...o(≧v≦)o~~好棒哈哈...太无聊料...所以拍张照...哈哈Like？~\(≧▽≦)/~ with Samantha Tyc.	joy
，讓你眼前為之一亮，和驚艷的作品唷!!	joy
，嗔什么？山逞强，水守弱，海底曾淹大西国位尊财旺休得意，名流倒台倍落魄时运无常，高升必堕，傲什么？心头镜，慢慢磨，学问功夫细细做谁信世间炒作客，飞蛾扑火自投锅抱[PERSON] ，不温不火，躁什么？	joy
 今天農曆00月00日是冬至吃湯圓來喔！大家一起來吃湯圓.吃了湯圓大家又年輕一歲了.	joy
 春日融融，春水潺潺。春草如丝，春雨绵绵。春风得意，春意盎然。春华秋实，春风满面。春花秋月，春色满园。春色怡人，春意阑珊。春回大地，春光灿烂。春暖花开，春风送暖。春节快乐，春满人间！ .	joy
Hiew King Soong  有。。。我老公有这么说过。《请也要对我老婆好》。。做老公的也要很有智慧的，做中间人真的很难。。我早已度过这些事了。。。感恩有你。。 with Hunter Ho.	joy
可以突破百人以上的成员。(^.^)Y感谢各位的关注与支持！Martin [PERSON] 老师澳诺语言中心 | Alpha Greeno Language Centre with Crystal Lean See Phing and Dick White Black 	joy
 早安!祝福好友們~新年快樂喜氣揚揚,(^ε^ )♡母親♡猶如大地,只要有她存在,青年就能如同大樹般成長茁壯。♡母親♡只要輝耀著希望,青年就能明朗愉快地前進。~以上是[PERSON] 先生的指導~嫁出門的好友記得年初二要回娘家孝盡母親喔！看看父親喔！ . 單純	joy
Terrence Wong  Myrosso乱online中文server Killer-No-Heart !!!!!!!!!!!!!!! 已卖出！！！！！！！！！！！！！！！！！！谢谢买家！！！！	joy
I want to make this  晚餐，外帶石二鍋回家加料ㄧ起煮寬爸：剩下的南瓜來做什麼好呢？南瓜派，南瓜湯，南瓜精力湯寬媽：ㄟ～～你說的我都不會煮丟下去煮火鍋卡乾脆啦	joy
This place is in Teluk Intan!  这也是我们决定要开小脚丫最原始的初衷希望培养出爱看书的宝宝看来在一个周围都是书的环境下真的很容易养出喜爱书的宝宝也有可能没有别的娱乐只好看书了 哈哈因为妈咪我在做事所以他们在旁边等我念故事给他们然后等着等着就自己看书了妈咪我还真是欣慰啊 with Patrick Tan.	joy
Very nice!!  雕作之美盡在.fb.粉專業的食雕創作者。世界級的雕作品	joy
提出了「四個星期法則」終止你對藥物的依賴，以及指甲按摩法、熱冷水澡、[PERSON] 等等，讓你在短短三個月內就能變健康。打造不吃藥的身體，其實就是讓你的身體恢復原本的狀態。而身體原本具有的自癒能力，其實就是最好的醫生！ with Jeslyn Jes	joy
 安顺的朋友们注意丫~台湾小吃“士林”将会在星期0营业~希望大家可以过来支持支持~实在感激不尽！Kamsahamida!!!	joy
at 臺北大學台北校區	joy
 两个宝贝在玩耍 :D .	joy
⊙C-000⊙C烘一小时或以上至结实及干身,取出待凉马上收好。贴士:蛋白糖霜饼只适宜采用低温烘烤,温度过高将导致外焦内不熟。为了使饼保持形状，烘好后关电，将烘炉门半开让饼继续置于炉内自然冷却，可以保持其脆度。食谱来自 Eva Yu 	joy
信息和證明檔案；為了安全，看完～請分享出去	joy
良善的[PERSON] 法跟大家熱鬧跨年看煙火但安安靜靜悄悄地幫助了一位有需要的人也是另類完美的句點祝大家新年快樂♥ with Ren-Yen Chen at 信義板橋代書中心	joy
 昨晚新竹「戴爾.卡內基.進階班」聚會，今天中壢新版本的「優勢銷售班」當學長。日子很充實〜能常和正向、積極的同學相處，讓自己更開心、更有學習的動力！	joy
 新年要到咯，想要买肉干的朋友们pm我。这是北海的[PERSON] 肉干哦，买三包起有包送到你家……希望大家支持支持，只限太平哦	joy
cool~~  0/00(六)晚上七點~靜謐時光在板橋000藝文特區演出喔~Free ticket .....順便可以去新月橋天空步道散步呢~ at 板橋000藝文特區.	joy
 明天0/00-00的[PERSON] 我都在OMG 攤位陪各位玩家玩遊戲呦～還沒下載我們的 *漢末群雄&三國萌戰記的捧由，快下載跟我一起玩～	joy
!!)活動限定門市一覽高雄建國店 左營新光三越店高雄林森店高雄自強店高雄五福店高雄燕巢店高雄六合店小港康莊店 高雄明華店高雄鼎中店高雄林園店高雄大發店 屏東潮州店台北永和成功店台北伊通街店台北內湖路店台北瑞光店 新北新莊幸福店 新北樹林溪北店 中壢復興店 台中一中店台中興大南門店台中大雅雅潭店 台中大里國光店 台中工學店 雲林斗六店 員林中山店 苗栗府前店 苗栗後龍店澎湖光明店 ...	joy
Good morning!  每一天，生活裡總有一些惱人的小事，試試正面思考，[PERSON] 在開始改變，相信人生掌握在自己手裡，你會更積極，也更快樂。常用喜悅的心情，去面對生命中無常的變化，抱持樂觀的心情去面對，隨時可能遭遇的挫折，要從順逆中覺醒過來，無常是生命的真相，放下是最好的依靠。今天你笑了吗？	joy
上00萬分感謝！！！  at 鹿港快炒	joy
 快來快快來陶藝、金工、素描、編織、琉璃、草木染、藝術傳播、繪本、插畫工坊聯展還有可愛的明信片可以拿 at 東華大學 湖畔藝術中心.	joy
 人生旅途陪伴是一種幸福~愛與被愛~是一種幸福~珍惜妳珍惜我~感動由心而生~珍惜摯愛^~^ .	joy
 #初二早晨新的一年，Hello Kitty祝福大家： 身體健康, 龍馬精神, 財源滾滾, 橫財就手, 事事順利, 升官發財, 心想事成, 步步高升, 豬籠入水, 愛情事業兩得意!! .	joy
 媽咪的鬆餅三明治 with 蘇菜.	joy
 昨夜有小醉，今天是大年初—还是要早起向大家说声～新年好! with Cheras Happy Hash.	joy
的祈求)”和“異體同心”的“團結”。≈以上是[PERSON] 先生的指導與鼓勵呦≈	joy
 Kagome Shan 哈哈哈~~你我都想知道的答案 XD	joy
[PERSON]  妻子心血来潮,站在镜子前仔细端详观察,发现自己竟然难看,老了很多,不禁放声大哭。坐在一旁观察已久的丈夫说:“你偶尔照一次镜子就那么伤心,那我天天看着你又该怎么办?” ❤️献给天底下。。。 疏忽保养的女人！ 女人一層不變,男人就會變;男人不改變,女人就會不見.	joy
一個目標,我們要合作要團結,改造后里成為旅遊重鎮,讓人人有飯吃有衣穿,不是天天等著政府救濟金或等著別人施捨,那是多麼悲哀!寧可辛苦一陣子也不要當一輩子的窮人,.	joy
是愛的告白。愛與痛，都要學習說出口。所有說出口的，無論傷痛或至愛，都是一種見證，見證生命曾經有過裂縫，見證受傷者的肉身與靈魂，是如何艱苦跋涉，又如何堅定走過最苦寒的生命之冬。	joy
我們自己身上！ATTITUDE（心態） A+T+T+I+T+U+D+E＝ [PERSON] 我們對待人生的態度才能夠000％的影響我們的生活，或者說能夠使我們的生活達到 [PERSON] 的圓滿！用什麼樣的態度去看待人生，就會得到什麼樣的人生	joy
 歡迎桃園各界長官好朋友們幫幫忙喔！^_^0000/0/00日(六)舉辦公益捐血愛心活動,地點：桃園市新埔六街和[PERSON] 路交叉路口轉角處 時間：從早上九點整起到下午四點結束請有空的好朋友們幫幫忙一同前去響應捐血公益喔。謝謝您！^_^PS.記得攜帶身分證件及一星期內未服用任何藥物者！	joy
新陈代谢，询问详情pm我吧	joy
 好漂亮的薰香燈！！謝謝老闆、老闆娘專程送來(^O^)還有各式KT產品，有需要請留言（＾∇＾） with 黃雯.	joy
 中午太后做了“小羊羊腿炖汤”，我用汤下了云吞，太美味了，o(∩_∩)o...哈哈！刚刚一齐吃完晚餐，我做了三文鱼pincho、芝士蒜茸焗大虾和油焖大虾。。喝了一杯气泡酒上头了，找周公去也！	joy
 生活不能等待別人來安排，要自己去爭取和奮鬥…而不論其結果是喜是悲，但可以慰藉的是…你總不枉在這世界上活了一場…夢行者分享”	joy
 今年的學生演奏會，實在是因為相當的忙碌而換了日期也讓許多的學生都無法參與這次的表演。但是看到這群年幼的學生努力爲著表演而犧牲玩樂和休息，實在給他們拍拍手。 做爲一位老師，真感到驕傲與欣慰。 我不能但上帝能。也特別謝謝一些朋友、學生、家長幫忙整個演奏會的預備。 沒有拍到你們的照片，就藉著這個平台，再跟你們說聲謝謝。 ...	joy
 「面對挫折時，相信自己擁有改變的能力，並且勇於嘗試。」 晚安，能解決就不要再煩惱， 不能解決就請先放手。	joy
：RM00还等什么呀。。。那么可爱的hello kitty power bank最适合当小礼物送给朋友。。	joy
g00d  生命的美好，就在於怎麼樣去珍惜緣份，善待自己，善待他人，心中有希望，腳下就有路！在順境中懂得感恩；在逆境中依舊喜樂；珍惜認真活在當下！好友晨安喜樂，週未愉快！ with Rain King.	joy
(Y)  吵架後先道歉的人不是因為錯…而是懂得珍惜！工作時願意主動多做的人不是因為傻…而是因為懂得責任！合作時願意讓利的人不是因為笨…而是懂得分享！喜歡經常請朋友吃飯的人不是因為錢太多…而是把友情看的比錢重要！幫你的人不是因為欠你什麼… 而是把你當朋友！有多少人忽視了這簡簡單單的道理…又有多少人覺得理所當然…	joy
GLOO00S  新产品这款现在韩国超火的纯天然猪皮水光睡眠面膜!纯天然手工制成。是韩国女星,童颜美女管理皮肤的秘笈。在韩国0天销量超过00000瓶!!!	joy
The red one is my brother!  謝謝[PERSON] 帶給我們一個，有人文，歷史，古蹟，趣味，美食的豐富旅行 with Walter Walter Tuk Tuk and Lin Douglas.	joy
My little nephew :)  昨晚得知自己上报了,谢谢光华日报分享这份喜悦,确实有点惊喜,四喜临门,得来不易,非常开心的心情。因为小宝贝你送给芭比和妈咪太多惊喜了。 with J-Way Lee and Serene Tan.	joy
 一籃子廢柴製作中	joy
Programs.  当峇央峇鲁国际讲演会的主席和委员要求我赞助时,我的钱可能不比人多,可是我的课程是不会比人少的哦一个星期超过00班的CEO 剑桥英语陪训课程 ;) 任你选 本语言中心第一次赞助非营利组织,感觉蛮好的.恭喜这位女士赢得本院的课程。Martin [PERSON] 老师[PERSON] Language Centre 	joy
Oh,uncle aunt good morning  各位多滴早晨幸運之星來請安太陽公公開口笑 柔柔微風財神到大家出門遇貴人好運富貴全圍繞身心安康家興旺開開心心天天好~點進去	joy
This is correct  不要把时间浪费在错误的人身上 .	joy
 農曆00月00日送神ㄛ(星期五)祝福大家新的一年好上加好,事事如意	joy
 心情好！去竹南啤酒廠看大陸小朋友0〜00歲馬戲表演及魔術表演！票價不便宜就是了〜 with 林巧懿.	joy
的十种食物，让你肌肉更强壮，身体更健康。 	joy
反省。（0）事項結束後，先審查過錯，再列述功勞。（0）認錯從上級開始，表功從下級啟動（0）著手一個計劃，先將權責界定清楚，而且分配得當。（0）對“怕事”的人或組織要挑明了說。 at 美而香_熱情阿姨早餐店	joy
下耶穌。遙遠的東方有三博士得到神的啟示，追隨天上的一顆明亮星星找到了耶穌，俯伏拜他，揭開寶盒，拿出黃金、乳香、沒藥為禮物獻給他。在伯特利野地的牧差人也聽到天使的聲音從天上發出，向他們款耶穌降生的佳音。讲完耶稣了！ 聖誕節快乐！	joy
参考 一挂就是七年 而且这七年 我们都不知道 是在我们复合后有一次经过这间相馆 才看到的 我们两个都很惊讶 也很惊奇 是不是 很早已预言 有一天 我们会回到彼此身边?可惜因为过了太久 相馆老板娘也找不回底了只好拍下这个广告条 做个纪念 ~Mr.Ng 以后我们要拍更多照片 弥补以前的合照被我们毁掉的遗憾啦~~ with Peter Ng. 当初00岁的我 00...	joy
, 他英文都很流利哦~ 	joy
 萬榮林田山…	joy
 #abmi 因为我喜欢[PERSON] 做戏，昨晚我和朋友去Spark MBO 看到哈哈大笑，男男吻，祼露的时候Yumi女主角说不是盲人的表情。。。还没看的朋友想笑的话[PERSON] 到功成包你开场笑到收场啊！	joy
，其实我也不知道他是谁）...那次他们...blah blah blah	joy
 甜蜜入侵	joy
 不要轻易暴露内心的脆弱学会承受应该担当的一切不要轻易述说生活的狼狈学会面对杂乱无序的现实不要轻易虚度每一天的光阴因为那都是你余生中的第一天不要轻易向世界妥协，它让你哭，不要在坚持中让自己笑。只要我们能承担，不逃避，会珍惜，人生就不会太苍白。	joy
 早上還不舒服！一旦遇到要玩就活力十足的他！三年來第一次有時間來參與兒子學校的活動！他顯得特別興奮！早上還特別叮嚀要來唷！唉！自己該檢討了……	joy
教学法 *团队教学法*新人训练班 *多项发展商新项目 与 二手房产买卖资料*自备交通* 我们的目标 ：“ 让你用三年时间换取三十年的空间 ”*想要成功，马上行动 ！* 听过？想过？快快用您电话通过 ！* 马上联系国际地产领袖* Desmond +0000 0000000	joy
，有效預防[PERSON] 栓塞，調整血液迴圈，減低血液凝塊。看完，告訴別人，把愛傳出去！！祝福您~平安	joy
Lovely Adrienna SpicyTuna Maplestory Bao Chunlai F0  今天是新加坡建国00周年囯庆祝福新加坡；生日快乐，国运昌隆，国泰民安Happy Birthday Singapore  	joy
歹歹..我想說去領點鹽回來加減用 您笑了嗎?每天三大笑快樂似神仙喔＾＾	joy
 春日融融，春水潺潺。春草如丝，春雨绵绵。春风得意，春意盎然。春华秋实，春风满面。春花秋月，春色满园。春色怡人，春意阑珊。春回大地，春光灿烂。春暖花开，春风送暖。春节快乐，春满人间！大年初一啰 馬年行大運 ！ .	joy
Good idea !!  出門前把[PERSON] 成汁，放進製冰盒，回到家把[PERSON] 的原汁冰塊丟兩顆到杯子裡，加點蜂蜜就成了好喝又健康的蜂蜜檸檬汁!炎炎夏日來一杯，養顏美容又省錢，每天出門前放幾顆到水壺裡，就成了檸檬水，很方便的，比起喝罐裝飲料健康許多，也很環保!為了自己的健康，動手為準備飲品也是愛自己的表現喔!!	joy
 再次[PERSON] 三甲與樂隊甲級動員！全部給我注意！請按讚方便統計人數！集結點：大年初一佳里區-因為我太想念你們了⋯^.^⋯  at 東莞瓏泰化工有限公司.	joy
 天氣好好！小Nana的嬰兒車初體驗 with Jeffrey Addington and Martha Addington.	joy
 願所有的幸福把所有的快樂將所有的祝福獻給最親愛的家人與好友們by Britney . 精典語錄+哩哩摳摳	joy
=000 ~ 度日如年 00、0寸加0寸 ~ 得寸进尺00、0除以000 ~ 百里挑一 00、000 000 ~ 三五成群00、0 00 ~ 一五一十 00、0，0，0，0，0 ~ 屈指可数00、00000000 ~ 七零八落00、0，0，0，0，0，0，0，00 ~ 隔三差五 00、00000000 ~ 缺衣少食00、0／0 ~ 七上八下00、0000 ~ 无独有偶00、00 ~ 颠三倒四	joy
Yenzie Lv Shine u wan try ka...i bring for u  Hac way槟城白加哩面真的好吃哦。。。我今天吃第二包了。。。连我送给顾客吃都说赞。。。够gao.... .	joy
 都沒拍到齁 鰻魚生日快樂 .	joy
 我是嘉義人(自己人) 0000-00-00 嘉義市中山路，今日新開幕 金鑛咖啡-嘉義中山店 二樓的主燈很特別喔，是用珈啡杯排起來的， Nice at 金鑛咖啡-嘉義中山店.	joy
出超完美的水煮蛋！	joy
 给宝贝们的一个惊喜。	joy
过的杏仁粒或糖粒做装饰By Yong Swee Ha 	joy
 前些日子介紹過的DELTA燈具現在接上電源瞜!!!是不是很漂亮呢!!! <0 一面素淨的牆面加上些點綴就可以很不一樣喔~~~ at 吾宿空間設計.	joy
Imm Yan Fbg Yap Kien Shun Steve Chew haha xD lucky we r not jek ^.^  一般男生見到女神的床上自拍是這樣的，然後加一句：「早晨喲～～～」，一眾男生就被迷倒……. . 请游览更多： visit：	joy
 四好人，真佛子。种善因，得善果。肯定一切众生皆有佛性，人性本善。存好心：真诚，清净，平等，正觉，慈悲，心同虛空，量周法界。说好话：不妄语，不兩舌，不恶口，不绮语，柔和诚谛。行好事：三福，六和，三学，六度，十愿，以四依四摄落实日常生活中。做好人：学为人师，行为世范。南无阿弥陀佛。	joy
 時代的演變，數位化讓距離拉近，也多了更多互動交流的機會，歡迎彰化縣 [PERSON] 乾[PERSON] 交流分享~ at 鹿港天后宮.	joy
 当您們看見這信息時，幸运已降临到你头上，財神已进了您家门，荣华富貴己离你不远，祝福大家新年快乐，，．．，	joy
 帮婆婆戴着年货。。 with Vvian Tan.	joy
 不用年終檢討，也沒有來年方針耶！哈～我怎好意思......幸福兒媳00年載.....(^ω^)	joy
Venus Lam  最新限量版的指甲油．太美了	joy
. 也谢谢昨晚所有被Paulina询问过一遍然后再带我去找她的Biomed亚洲姑娘们～你们都太可爱, Ella Xia～～！虽然此刻不一定能看到，but when you do, hope this makes your day as well.	joy
：「 我想 ..... 他可以直接升國中了 ..... 剛剛妳問的那幾道題，我一題都不會 ..... 。 」看了連我都 暈了！ 	joy
，人人都可以！	joy
[PERSON] ~  你的決心，你的態度，決定你未來的命運！ with Martin Li.	joy
S0 at 聚福海鲜饭店	joy
 説的真好！[强][强][强][强][强]跟客户争，你争赢了，客户走了！ 跟同事争，你争赢了，团队散了！ 跟老板争，你争赢了，平台悬了！ 跟家人争，你争赢了，亲情没了！ 跟朋友争， 你争赢了，朋友少了！ 跟谁争，争赢都是输，不如跟自己争，把自己做大做强！自己才是真正赢家！ ！！	joy
So many heart shapes on this apple!!! ♡♡♡  大家下午好！ =)饭后一粒苹果，医生远离我～ <0 <0 <0（管理员： <0 Zoe ）	joy
關注。據稱該事件[PERSON] 留下了深刻印象。[PERSON] 於0000年0月在北京澄清：「真正的起點是，我曾經從荷蘭一位畫家的風景畫里看到一隻鴨子。」[PERSON] 表示於0000年時，「橡皮鴨」在其頭腦中僅是一個概念，經過0年才最終誕生。	joy
人0000年幸运颜色为褐色、灰色、米黄色、红色、白色。0000年忌讳颜色为绿色、青色、蓝色。属猪0000年幸运色 属猪的人0000年的幸运颜色是白色、黑色、蓝色、灰色，忌讳颜色为红色、橙色、黄色。	joy
。特别是这样，你还是知道，他永远会关心你的。做不成男女朋友，当他那个特别的朋友，有什么不好呢?有这样一个人我很喜欢却不忍动情~~因为我知道如果我们成为男女朋友我们就不能像现在这样无所顾忌的无话不谈 ，我会更在乎他对自己的看法因为我知道如果我们成为男女朋友我们就会要求对方更多，想占为己有，会吃醋，会吵架……到最后也许会分手…………所以这样最好…………	joy
Happy birthday sweetie  自己做了顿很奇怪的饭～嘻嘻。 早上醒来， 老爸老妈老妹老弟， 电话不断。原来是我的生日。 今年在老妈的批准下，今天生日快乐	joy
 親愛的老爹～生日大快樂！祝身體健康，平平安安！禮物一個在肚子理，另一個臺灣領！ .	joy
OMG  走上时尚尖端	joy
█ ◥██◤★ 吉祥 ☆ 如意 ☆◢██◣▲∵☆ ☆█圓满█╰╮◢██◣☆◥██◤∵╰╮╰╮ █富貴█☆ ☆∵▲◥██◤ 我愛你粉絲團小珍粉絲團╭╯◢◤▲ 愛您們呦！☆╰╮╭╯◢◤ ▒♥▒♥▒♥▒♥▒♥▒♥▒♥▒♥▒♥▒♥▒♥▒♥▒♥▒♥▒♥▒♥▒▒♥▒♥▒♥▒♥▒♥▒♥▒♥▒♥▒♥▒♥▒♥▒♥▒♥▒♥▒♥▒♥▒ ...	joy
个人，让我放肆的做回妖精！	joy
Black Jing  大量收购二手/全新名牌包！！！接受：高价寄卖，现金直接买断，以旧换新！PRADA, LV, GUCCI, CHANEL, MIU MIU...欢迎来电预约时间: 0000000000或亲临Penang Times Square 底楼 00号！ .	joy
 四隻老虎圍著一匹馬，一旁坐著一隻猴子。誰最牛?兩隻各喝一小瓶海尼根，我喝一杯可樂，其餘喝吳韋德特調奇異果果汁。[PERSON] 昨晚很難賺!左岸老闆和Wade 賺到一台東訊賈伯斯新年禮物，貿喜!!  	joy
 東京温泉	joy
De Croud寫的，在0天内將這信息發送给00個親朋戚友，在0天後你的幸運將會降臨。反正line不用錢。00小時内轉發，明年就會一切顺利 (heart)(heart)(heart)	joy
 大年初一，所有女人都不能戴胸罩，寓意新的一年没有凶兆，所有男人都不能穿内褲、寓意新的一年没有累苦；記住轉寄哦！新年快樂溜	joy
 ~~~聖誕節 出了點溫暖的陽光~~~MERRY CHRISTMAS~~~~感覺好舒服 慵懶的感受這個特別的節日~~~	joy
本人式用的一模一样的才能和我的脸一样达到好效果呀。。。外面别人在卖或推销的我没理也不敢说有多好用。。。我只敢大声说我这个好用因为我都一直在用的。。。	joy
 彰化縣企業經營研究協會 舉辦第二十八屆新會友[PERSON] 0.時間：000年0月00日(星期三)晚間0:00。0.地點：[PERSON] 早味料理(和美鎮[PERSON] 三段000號，原卉春生機蔬食休閒園地)電話： 00-0000000 。※敬邀新會友踴躍參加。	joy
出货。。。出货 00/0/0000星期一，省电器+ tokebi今天已经全面发出了，祝大家收货顺利。by TA-Q-BIN & POSLAJU .	joy
 很快星期天就是大过年的冬至要到了[哈欠] 天气随着这个节日使到有如冬天的感觉♥冰冰冷冷的 大家来碗汤圆 祝大家冬至快乐	joy
Shaney Tan don't forget to claim ya...  巴生人 是selangor baby就 快快去申请和拿罢。。。goverment给的我们就要拿罢了。。	joy
 yanhee slimming pills见证效果，顾客见证点击链接查看有关详情	joy
yes!!!! 幾歲結婚不太重要，重要的是選對人。寧可找到合適的，快快活活的過十年，也不要被愛情沖昏頭，或在各種強大的壓力下，隨便抓一個就步上紅毯， 卻悽悽慘慘的捱00年。晚結婚並不可恥，沒有結婚也不丟人，結錯婚才是萬劫不復。 . annt這是昨晚國畫課的作品要送給你滴~~有show 名喔~~	joy
 一個人，心念變了德行就變了。。。德行變了，氣場就變了氣場變了，風水就變了風水變了，運氣就變了運氣變了，命運就變了所以，改變命運真正靠的是自己的正能量，厚德載物内心善良、柔和、寬厚...必長福相，那是多麽昂貴的化妝品都裝扮不出來的相由心生，境由心轉。。。妮妮用心生活	joy
,每個身邊的朋友和我愛的家人都開心並且平安,那是唯一希望!!不需要求多富裕,安全是一切...能讓你開心過每一天那就足夠!!	joy
 非常開心能與所有的夥伴精心策劃這場屬於No0一周年的party。從副理 店長與助理設計師團隊都在這場活動扮演非常重要的角色，因為大家的攜手合作讓身居model角色的我們能很有自信的走向伸展台，畫下美好的結尾！	joy
 謝謝芸芸姊 !讓我們家可以換一台00吋的液晶電視 !爸媽開心 我也很開心 ! 0000年 好順 一直這樣下去 !	joy
在你自己的手（机）里！想了解清楚的就看看网页吧，不明白inbox我！O(∩_∩)O谢谢！感恩！有兴趣请加我好友后pm我吧~或联络我也可以！0000000000 kelvin 参考下没有亏本的！不明白可以inbox问我^^。	joy
 分配好……就要送饼给客人了 (^_^)/♥祝大家吃了吉祥[PERSON] 如意饼……新年发大财 ~\(≧▽≦)/~♥  at 美罗火车头.	joy
效率, 00倍的锁水功效。 有兴趣欢迎找我询问更多详情╭(╯ε╰)╮ with Ah Lean	joy
Rachel Rui  人不会苦	joy
。[PERSON] 祝福你 不遲疑～現在就趕快去辦台灣政府身份證及0000位政府官員訓練，對您的未來，一定有異想不到的好處和福報！但一定要先付出及智慧。	joy
Proud of my hometown!  The most beautiful moment!這一刻等再久都值得。親眼看見的那種感覺，真的超不一樣！Peng Bay Bridge opened at 鵬灣跨海大橋.	joy
与女性朋友们享受我的高级精油SPA手脚护理（原价RM000）！如要预约请联系 00-0000000 / 00-0000000.  	joy
 一年一度的家庭尾牙！期待了好久～><～因為二伯母做得真的太～好吃了啊！外面買不到更好吃的呢！ .	joy
Rebecca JiangWani Lin 我來不及了嗚嗚  Pioneer DJ Taiwan 對自己喜歡的事要努力堅持下去 (y)	joy
 eTag不爽裝 免儲值 一樣上國道 一萬張eTag不爽貼，加倍奉還 -加碼送靜電貼時間：00:00~00:00凡現場撕eTag或持撕下的eTag者，送	joy
 光陽 GOing 000 限時搶購純代步 不整理 引擎良好有力0000元(含過戶.保險) at 佳陞車業.	joy
／  在app的料理食譜裡看見的《蜂蜜檸檬汁》進階版!!先用菜瓜布打檸檬外皮洗乾淨，避免農藥殘留，在來把檸檬切片，然後放進乾淨的容器裡，再倒入蜂蜜蓋過檸檬，然後放進冰箱醃0天!到時拿出來加冰開水，就是好喝的蜂蜜檸檬汁嘍～看分享的人說，有瘦小腹和大腿的功效喔！很期待喔～三天後揭曉…	joy
^ω^ )第0奖：珍藏Chevas一支！第0奖：红酒 x 0份第0奖：Carlsberg 啤酒一桶 x0份如有不便之处，敬请原谅。分享站全体工作人员恭祝各位有个美好的圣诞节！（≧∇≦）若要询问详情，欢迎拨打0000000000（Eddy Ng) at 分享站歌唱中心	joy
: 0韩国顶级明星排行榜， , 投票網已附上, 多謝!朴有天 預祝你~~韓國最棒偶像演員, 想你,[[PERSON] ][0天][JYJ 第00屇仁川亞運會]~~成功! 加油\*(^O^)*/❤`•.¸¸.•²²¯`••.¸¸.•²²¯`•²❤ with Peanutsnoopy Lucy	joy
 哈喽,大家下午好~周末无聊就来些刚做好的糖霜popiah吃吧!嘻嘻(^_^)	joy
 職業國標舞世界大賽000將在台北小巨蛋登場!薆裟樂舞坊國標舞老師[PERSON] 老師有參賽對國標有興趣的您歡迎跟著我們一起去幫阿德老師加油!!加油!! . 最新資訊通通在這	joy
 夜遊、夜遊……！！一整車的女人要去永和[PERSON] …哇哈哈…連我都被自己打敗了…（培培、真姐、雪兒、me、其他的走不了還在顧店……)明明就沒喝多少、怎麼做這麼無聊的事餒…哇哈哈…！好久沒這樣嘍！	joy
 Multi-function jump starter用了一个多月了，今夜出厂是第二十个见证一次就可以起动汽车引擎的好帮手，充电话00分钟内充满，可以连充四次，用到现在已经值回票价。 with Wei Yea Lee.	joy
；晉升區域總經理，有更深的使命與責任，我會繼續努力，謝謝您們！	joy
— 覺得好舒服，在 Rekjavik 。 in Hveragerdi, Iceland	joy
 微笑永遠是一個人身上最好看的東西！信用一直是一個人身上最值錢的東西！家人永遠是一個人生命最珍貴的東西！友誼一直是一個人生命最難得的東西！相識是最珍貴的緣份！祝福是最真誠的問候！早安！好友！	joy
 魅力是什麼？魅力不是漂亮，漂亮的女人不一定能吸引人，端莊幽雅的女人有人才喜歡。所以你不用擔心自己不夠漂亮。早安 週五 吉祥順心	joy
 丟000佢路姆西	joy
Cheers Friends from Taiwan & Szechuan at KB Beef Noodles (Restoran KH00, Puchong Jaya) yesterday. 感恩有机会让我带来自台湾和四川的朋友尝尝我妈妈的牛肉面。他们赞不绝口～我们三种不同的华人在此交流、切磋不同国家的特色与文化。我昨日真的是大开眼界丫！ with Yin-bai Chen.	joy
 今天帶小朋友參觀台中公園所內容介紹各項警用裝備宣導各項交通安全、預防犯罪……等。裝備有00手槍、布槍、鈍牌、手銬、防彈衣、無線電、大盤帽、反光背心等各種警用裝備並且當場示範，讓小朋友瞭解警察平日的工作內容與服務項目 ，之後〝園區巡邏〞，來到園區內，古色 古香更樓、日據時代鳥居、著名市定古蹟湖心亭，員警一一介紹。 with Eric Wang and 0...	joy
 如果你不勇敢，沒人會替你堅強，如果你不快樂，沒人可以讓你幸福。快樂、勇敢都是自己給自己。只要願意，你就擁有。你[PERSON] 在自己的生活嗎？	joy
 甜點是我們一來就指定要的香蕉派，聽說這個每天有限量，而且要早點指定，才不會準備不及，所以我們就點了這個香蕉派。一上來的樣子真是令人興奮，滿滿的香蕉片在上面啊！派皮很酥，內餡是甜奶油，很棒的甜點~~~	joy
 胸不平，[PERSON] 天下... . CoNsの搞笑短片 music 图片と星座 栋笃笑 经典爱情语录 | 	joy
 全新leaflet同卡片，我好鍾意，還有客人讚㖭！	joy
 早安吖...难得的星期六休息...∩__∩	joy
 YA....終於完成了最好一次整體造型課的實做了,這次的整體服裝飾品都是小組組員一起手工完成，可以好好的準備下一個考試了...... .	joy
 中西合併，一起歡渡佳節！Y(＾_＾)Y with 陳玫蓁 at 土城聖德宮.	joy
 花開富貴，好心情每天綻放！（國產聯想A0000平板電腦拍攝）	joy
0000年幸运颜色为褐色、灰色、米黄色、红色、白色。0000年忌讳颜色为绿色、青色、蓝色。属猪0000年幸运色 属猪的人0000年的幸运颜色是白色、黑色、蓝色、灰色，忌讳颜色为红色、橙色、黄色。 with Josey Yeoh	joy
以上是这配套是0样产品！严格来说是0样哦！！因为眼影下面那层是腮红=）有兴趣自行inbox我～不要叫我pm!照片全在相册了，可以自己去选色！谢谢=)欢迎来抢购！嘻嘻～	joy
 交換禮物大成功 .	joy
 之後水水們買毛衣不知道怎麼清洗可以看一下圖片教你如何清洗毛衣Ps千萬別懶惰給洗衣機洗喔！	joy
 傍晚時分，彩虹乍現。 at 法鼓山農禪寺.	joy
Cruel smiling face  網路看到的 ，這不是我做的 ，分享給大家開心 ，想做還不一定做得出來吧	joy
濃郁到沒話說用心ㄓㄓ的精美卡片和超實用禮物又看妳的字看到流眼淚了哈哈0000平安夜久違的禱告好安心0000聖誕節Laduree legend好吃到要落淚大夥們驚呼連連控金的法國馬卡龍果然不是蓋的謝謝每個送我各式卡片禮物祝福的你沒想到能這樣特別到處聖誕節味道還有幼稚買喜歡santa的氣球我ㄧ直笑皺紋好深謝謝你們的ㄧ連串驚喜讓台北00月停留在永恆的超現實裡面 with Juno...	joy
 攝於：0000-00-00 BELLAVITA 寶麗廣塲 BELLAVITA 寶麗廣塲 ，繽紛魔力，耶誕水晶球。The Macallan 麥卡倫-全世界最珍貴的威士忌  	joy
人生 還有幾十年呢..	joy
讚  風言風語財富的建立來自你解決問題的能力而解決問題的能力來自 資訊落差(資訊落差)你懂得別人不懂的資訊而要懂得別人不懂的資訊關鍵在於 你周遭的朋友是誰感恩身邊有一位超級領袖[PERSON] 陪伴00年教育背景 國際領袖經驗輔導數十家的總顧問 曾領導上百個團隊的經驗真的是強大到爆炸 感恩[PERSON] 總昨日的盛情招待小風 with Mei Chuan Chan and...	joy
 感謝Daphne姐邀約到八里球場打球，今天也打出了最佳成績000桿，差一點就能破佰了，真的好可惜，不過還是打的很嗨森^0^期待下一次再相聚打球嚕！！ with Daphne Tseng.	joy
 把温暖的祝福，平安的问候，健康的心愿，温馨的心情，团圆的吉利，化作一条万能祝福，在除夕夜这个幸福时刻，送到你面前，愿你看到是福气，读出是喜气，事事有运气，天天有财气。新年快乐	joy
 很多媽媽都很怕給孩子穿白色衣物、因為髒了不好洗。但是我很愛白色、還好我用安麗衣潔系列、方便、快速、不殘留、不傷衣物、防鏽配方、還有味道清香！但凡是髒污、蛋白質（口水、血液、屎尿...）、油污 等、都能輕鬆洗淨！重點是、我沒用手洗、是洗衣機洗喔！免搓揉！價格合理親民耐用！歡迎密我～	joy
 今天溫溫跟美麗的妞妞們開心的在企業尾牙演出，我們也感受到抽獎的歡樂氣氛，祝要參加尾牙的大家，馬年行大運、馬上中大獎。最近好冷暖爐都出動了，大家要注意保暖唷！你們猜猜我在想什麼呢？ with 施佩雯.	joy
:像你這種人，在連續劇裡，最多只能活0集。 00:早上起床我以為我一夜之間長高了，結果才發現是我被子蓋橫了。 00:每次考試我都好想在卷子上寫滿“百度一下，你就知道”，氣死閱卷老師。 00:看完不轉載，只能對你說：可惜了你的一雙眼睛... 歷害	joy
、昨天、每一天我都超感謝佳興老師～因為我真的變了許多雖然沒有向其他人那麼棒但已經是有改變很多了～我慢慢的往前邁進～謝曉柔，你是充滿愛與喜樂最棒的！  at 佳興成長營-實現你渴望的夢想	joy
。 at 公館[PERSON] 0號出口	joy
Wymund your new boy friend  早安好,好久不见FB的朋友	joy
hahaha longkang night market  马六甲人 各位商家，龍港邊夜市今晚正式开始营业了，都准备好了吗？请准时开业哦！祝各位生意兴隆，财源滚滚！ at 龍港邊 Thirteen & Half Street Night Market.	joy
 祝福朴有天，朴有焕，JYJ 小米们，粉丝们，朋友们，出入平安，同意的就转，不要平安停下来，好好玩哦!	joy
●加速伤口愈合速度●改善皮肤弹性●对眼睛保健如预防夜盲症，干眼症，白内障和老化有关的黄斑区退化症都有临床研究●减轻过敏症●辅助胃肠道的消化系统保健●辅助治疗痔疮，胃酸过多和十二指肠溃疡●预防风湿性关节炎和骨关节炎●增强肌肉和骨骼●辅助减轻咳嗽和化痰●强化肾脏●缓和头疼和解除眩晕●改善睡眠问题●维护牙龈健康	joy
[PERSON]  刚煮好豆奶燕菜，只需两种材料，就可以弄出像豆花般的口感噢你们想试一试吗？ .	joy
..陸陸續續一些車友開始換重車...由於常時間接觸，也讓我對此的興趣越來越濃厚！四缸的重車對我而言，實在是有非常大的吸引力！接著到00歲就去考了大型重型機車駕照，然後持續的去租重車，直到現在...我買了人生中第二台的檔車-小黃蜂，雖然排氣量只有000 cc，但是四缸的聲音及騎乘起來能徹底釋放壓力的感覺，讓我愛的無法自拔...。生日快樂！	joy
昨日真的是大开眼界丫！ with Yin-bai Chen	joy
 心血来潮炸cempedak,用tokebi料理棒的泡沫刀把面粉加盐加点木薯粉一起打滑，面粉打到很美很滑，不会一粒一粒起泡，且不到两分钟就打滑了，很棒是吗？	joy
在拍些照片分享這把老琴给各位。 with Paul Cox and Neal Moser	joy
 今天坐的飛機~ at Tan Son Nh	joy
SEng HOe hahaha....your team is??  0000 世界今夜零时開跑,你还等什么。。。	joy
PM美丽店主 AiTee Chia购买，品质好价钱合理，买0件包邮，大家别走宝咯〜 with AiTee Chia	joy
Waa...so special car plat drive to malaysia from china?  刚在云顶半山看到这辆车 很佩服他是怎样做到的叻？从中国驾过来哦？！	joy
 Congrats Yuki & Juno!!  at 大戶屋 大安店.	joy
 Forever 人氣熱賣～ [PERSON] 唇膏 ALOE LIPS~ 結合 蘆薈, 奧巴油, 蜂臘, [PERSON] 破裂嘴唇. 保持濕潤 .	joy
Princess  前几天工作还是第一次在现场演出有男士下跪送花，可能是衣服的魅力。 .	joy
 就這樣也好～只不過少個人來愛～沒什麼大不了!姐妹們～加油～我的好友們～假日愉快～ at 莫ㄟ懶洋洋在床上滾滾.	joy
 [PERSON] ,今天您送给我的金玉良言！我会收藏起来的，要用微笑来面对一切大小事！让我们一起加油吧！ 	joy
 吃飯皇帝大~之許多的事情，總是在經歷過後才會懂。例如感情，痛過了，才懂得如何保護自己，傻過了，才懂得如何適時的堅持與放棄，在得與失中我們慢慢的認識自己。其實，生活並不需要這麼多無謂的執著，學會放棄，生活就會變得容易。有一種感情叫無緣，有一種放棄叫成全。災嗎冰U？開動囉^_^ with 寶 貝.	joy
 星巴克分享，0000/0/0，0/00，0/00買一送一哦! at 0-00.	joy
 昨天提早庆祝儿子对岁〜吃红鸡蛋咯〜妈咪祝宝贝健康快乐长大噢〜 with Ah Ming.	joy
 早安哦！☀️☀️☀️今天是正月初入今晚过了十二点就是年初九！一年一度的天公诞是我们每个福建人都大拜的节日！所以00也不例外...期待已久的天公诞终于来到！祝愿大家恭喜发财，万事如意，马年行大运！记得今晚我们的约定朋友们！有拜有PoPi...00<0<0 	joy
We LOVE Amaranthine DEER PLACENTA 00-0000000  我们的WXY star Product！产品询问零售／代理／批发000 0000000  	joy
Armie — Low Lee Cheekong Elaine Wong  巴生人 是selangor baby就 快快去申请和拿罢。。。goverment给的我们就要拿罢了。。	joy
 今天是我家海运老板的生日在这里我代表海运❤️❤️❤️全体员工和亲爱的家人献上最真诚的祝福：生日快乐！事事顺利！天天都有大虾载，希望烦恼快离开他！Huat ！heng！Ong啊！谢谢你的合作让我老板有个难忘的生日蛋糕！D'signer Cake .	joy
了全身能干净和达到美白效果，还能散发魅力象拥有婴儿的纯净肌肤。。。有兴趣，请留言inbox 向我订购！:)	joy
 香噴噴ㄉ金線蓮雞出爐囉！！ at 嘉義水上溫暖的家.	joy
 维玛网路工作系統，建立自己的賺錢管道！一個真正在家工作，真正是網絡賺錢好方法。。~~就算穿著睡衣也可以完成任務！不必出門見客，不必囤貨，一切一切只在家裡完成。。想改變只需一分鐘填資料 ~免費報名哦，報名之後請check mail .	joy
 今天長這樣(☆_☆)一早九點就來為[PERSON] 彩排雖然只睡三個小時但我完整髮妝吃完早餐還提早了00分鐘到喲❤️一日之計在於晨～所以今天整天都會順利的但好像要彩到下午耶Gogogo[PERSON] 大家要來喔我在PS0區動動手指幫我的粉絲團按讚和分享 at 臺北世貿中心展覽大樓（世貿一館）.	joy
 最近比較忙，不過很開心噢〜就快要過年了，好多顧客都已經預約時間做眉毛了，因為眉毛對五官來說是很重要的，做了立體仿真植眉後，是會提升五官，也會讓整個人看起來更加有神的噢〜你們還在等什麼呢?趕快inbox我，了解更多有關詳情吧〜	joy
。那些年少的浮躁，會在生命進行過程中蛻變的平和而深遠，生命的美，就在於經歷人生起起落落後的安然。安然，是歲月深處的一種靜好；是繁華過後的一種美麗，是品嚐過人生的千迴百轉後的從容。珍惜當下，便可安然。	joy
 今天下午佈置和搬送物資，是幾位國高中生的小妹妹(還有老妹我與烏[PERSON] )妹妹們爬到兩層樓高在綁燈泡掛吊飾，而且超專業都知道該怎麼調電線，好厲害！只有你們幾個卻願意在寒風中付出時間勞力，謝謝你們，你們就是聖經裡那最低調卻忠心的僕人必得神祝福。晚上還要趕緊接著練歌隊和團契節目，真的要給你們拍拍手！	joy
 心中有爱人生的风景就是阳光因每个人的心灵 就像一面镜子在自己的心中 反射出自己眼中的花花世界 有人感受到美丽灿烂有人则感受到夕阳无限好 只是近黄昏用什么样的心灵镜子就会反射出不一样的心灵风景♥这剛在我家露台拍滴	joy
南海古佛......感謝賢士幫我翻譯。我要離堂了，我要牽著姊姊的手離堂。此後也將是我要助道的開始，我很感恩，我一定會好好助道。姊姊，我在妳的身邊，我們一起加油。  at 香港九龍	joy
手機：0000-000000	joy
音影音生活，最專業的技術整合，最豊富的影音震撼，將您的影音規劃，化繁為簡，影音極緻的撼動魅力最，真實的影音感動，愛影音，愛生活，優質首選盡在 嘉義醉音音響 醉音影音生活的長工地址：嘉義市隬佗路000號 聯絡電話：00-000 0000營業時間週一 - 週六：00:00 - 00:00電郵地址：et.net 	joy
變成固態，從而影響消化。固態油脂在酸的作用，變成小碎塊，比固體食物更易於被腸道吸收，並附著在腸子的內壁。很快形成脂肪，導致癌的生成。所以餐後要喝熱飲。如果將此文轉發00人，你至少救活一人的生命，甚至是你自己。	joy
♥CNBLUE//台灣首站 ※ ============================== PS.奉上第00屆金唱片典禮紅毯新聞圖 容和MC Fighting!!! CNBLUE Fighting!!!! JTBC直播網址連結:  with Vimutsed Charu and Sara Maxx	joy
 來店好禮~只要跟米妮打卡+粉絲團按讚分享就可以免費得到高檔名牌小香水免費的喔，趕快告訴你的朋友一起來	joy
like  贴一片秘密武器然后睡到自然醒睁开眼睛开始就会开心有自信 .	joy
I love this ..imitation sincere admiration  一起跳舞！	joy
.一輩子，說長很長，說短很短！請珍惜朋友，親人，夥伴在您身邊的時光，錯過就過了！。00.感恩天地，感恩父母，感恩兄弟姐妹！因為這輩子相遇 ，下輩子不一定再遇上. at 我的玫瑰園	joy
 「想像動力-新竹疾風分部」的車友們！別說我對你們不好...這個紅包你們大家拿去分一分吧...祝新竹疾風車友們...新年快樂唷... .	joy
 [PERSON] 第三天 <0我復活了～昨天的按摩真的好有效我也狂吞[PERSON] 今天有滿滿的笑容哦有來的趕快來找我吧而且今天還可以陪你們玩電玩～拜託幫我的粉絲團按讚和分享 at 臺北世貿中心展覽大樓（世貿一館）.	joy
 冰箱全是燕菜	joy
 0000年歷修正版歡迎收看 信大電視台 {歡迎分享}晚上00:00~00:00 快樂歌聲名智VS子芳 . HONDA車　　型FIT排 氣 量0000年　　份0000顏　　色灰色系配備:ABS.皮椅.前後行車紀錄器.CD/DVD中控/空力套件/防盜	joy
 爸媽Swee Thaim LeeChooi Kam今晚不要開心到睡不著覺喔 哈哈哈 謝謝學院頒這獎給我 我會繼續往上爬的 我愛你 我的家人<0 	joy
Good  出門前把[PERSON] 成汁，放進製冰盒，回到家把[PERSON] 的原汁冰塊丟兩顆到杯子裡，加點蜂蜜就成了好喝又健康的蜂蜜檸檬汁!炎炎夏日來一杯，養顏美容又省錢，每天出門前放幾顆到水壺裡，就成了檸檬水，很方便的，比起喝罐裝飲料健康許多，也很環保!為了自己的健康，動手為準備飲品也是愛自己的表現喔!!	joy
 爸爸妈妈们，我们皇后超级幼儿园全体老师在此祝贺大家新年快乐，事事顺利。很感谢爸爸妈妈们一直以来给予我们大家的支持与鼓励，让我们能够一直进步下去。在此对各位家长们致以万分谢意；对于小宝贝们，宝贝呀，你知道才过了一天老师就想念大家咯，宝贝们，新年要多喝水哦^^ .	joy
True...  日久不一定生情 但一定見人心	joy
，[PERSON] 土不能搞，色情賄賂我不要，清白才是一把罩！ 請你善待和平鳥，平時鼓勵給依靠，多給支持不放砲，警鴿才會有力道！.	joy
排毒功效的发挥~身体排毒后，脸上的痘痘和便秘问题会自然离你而去⚡️现在就pm美丽店主Win Queenie下单或wechat：queenie0000..sms：000-0000 000也可以哦让自己成为零毒素的苗条美女呗♥♥♥ with Win Queenie	joy
好邁進不逃避所有責任及困難✨✨fighting fighting✨✨0月進入尾聲，大家辛苦了0月期待方淳區的每個人都有好的開始☆*:.｡. o(≧▽≦)o .｡.:*☆ with 葉宗鑫	joy
 又改寫單天單店記錄，感謝老天，感謝各位爸爸媽咪們支持!感謝各位老友的分享支持!謝謝您們! .	joy
0000年水彩创作至今, 终于要把作品集中展示给大家观赏。恳请各路水彩界的英雄好汉莅临指教。更多展览详情会在日后公布, 敬请期待 	joy
Snow Peng Suet Shin  世界盃正式結束！徳國得到勝利！0年後再戰！球迷們都有覺好訓啦！哈哈	joy
 兄弟们：yes0欢迎大家在00/00/0000来到我们的大家庭yes0pub，渡过一个热情的《平安夜》，我们將准备了一连串的抽奖，让大家一起渡过一个快乐的【圣诞节】。欢迎光临。	joy
。也希望我們能在不完美當中學會 如何的完美!! with Weasley Jin	joy
Help me to like my sister photo Please  粽子啊粽子 ~~ 怎么你会那么好吃 ？ xD 端午节快乐哦 哈哈 .	joy
 古人造字有道理,若想成為贏家0.要在[PERSON] 有危機觀念0.要有溝通能力0.要懂善用時間0.要有投資概念0.要有堅持到底的平常心 如果你下班的選擇是開（騎）車回家躺在沙發上看電視（腦）、滑手機你的人生 輸給了你自己！	joy
․【 什么是培养人才？】敢于给员工做事的机会，也能给员工犯错的机会，这才是培养人才！真是深有感触啊!我都是自己不干，员工干，不管快乐与不快乐都要干。	joy
：抽0位。按讚破 00000、分享破 000：抽0位。按讚破 00000、分享破 000：抽0位。按讚破 00000、分享破 000：抽00位。※得獎人如封面照有更換成 水巫小雪新封面，則再加送一張小雪簽名拍立得。※ with 莊詠惠 and Winnie Chuang. WINNIE.SNOW:+LIFE...	joy
尾草精油0滴+荷荷巴油00ml將精油混合調勻後，在掌心搓熱，將整個手掌從左胸根部沿著胸部外側向上推至鎖骨，重復00下，換另一側。	joy
~延續 影像坊 [PERSON] 0000-000000 	joy
MY IDOL^^  JohorKaki美食部落格专访内容:-)	joy
 美好的愛情它不是偶然，它需要時間和耐心還有信任，讓兩個想要在一起的人共同去經營，即使我不在你身邊，你都能夠把我放在心裡，避開一些不必要的誤會，讓彼此放心，這才是真正的愛情。	joy
 富貴花間露 榮華草上霜將煩惱困惑都淡化了都轉化了用心靈去體會去掉繁雜心中自然平安喜樂	joy
 金龙玉马来交替，新春祝福送给你：东行吉祥西平安，南走顺利北康健，左右逢源有好运，前后福星照屋檐，内存千金，外有机遇，以上都是新春贺礼。 .	joy
 彰醫小0又有花樣了，南彰化第一家讚啦：0/00開賣了，0/00日下午四到六點open將有熱鬧見面會，邀請大家來一起共歡喔	joy
 我们公司广告再次上high way啦!!!!!!!!谢谢每位亲爱的顾客!!!!!!!  	joy
 各位好朋友。因轉左电話新型号。希望大家在閒時WhatsApp那處Hi我方便尋回	joy
 高艷妮 你家宝贝喜欢的阿噹！祝你们圣诞快乐。。	joy
来和我一起*享瘦*吧(*´∀`)欢迎PM我哦~WhatsApp/SMS/: 000-0000 0000 	joy
五歲自閉兒 對第一次接觸波比時的緊張，輕摸後快速縮手，直到現在這小朋友會主動舉手要接近波比（因為他已有可靠，熟悉與安全感）這位小男孩無法說話形容，而開心的用手手比出愛心❤️手勢，害羞微笑了！（波比麻當下看到時好感動喲） with Na Na	joy
 感恩有祢同在！！！早安！！！[PERSON] 啊，我從深處向你求告；主啊，求你聽我的聲音。願你側耳聽我懇求的聲音！我等候耶和華，我的心等候，我也仰望他的話。我的心等候主，勝於守夜的等候天亮，勝於守夜的等候天亮。(聖經．和合本, 詩篇 000:0-0,0-0) at 美滿家.	joy
 京都奈良東大寺楓與鹿的相遇，令人懷念	joy
 冬至冬至让你的快乐如期而至，让你的幸福无所不至，让你的生活至善至美，让你的财富蜂拥而至，让你的事业实至名归，让你的好运时至运转，我从头到尾志真至诚，只愿你感觉宾至如归。冬至快乐！ .	joy
 蕹菜纳吉发財包终於出炉了，又纳吉，又发財，好極了，快来品嘗。	joy
 0/0 party 的 海報與傳單已經出爐了呢 ！要做就做到最好 錢 花多花少都不重要 ！重點是成果漂亮明天 我自己編冊的小雜誌 也會出爐囉！ 大家期待哦！ .	joy
 Hongkong朗豪坊的圣诞girl派gift，嗨心。	joy
 沙发没来时觉得客厅蛮大的，结果沙发一放下去，顿时觉得客厅变小了，不过爱热闹的我们就是希望有多多位子给客人坐，无变^^ . 记录生活里的点点滴滴，享受生活里的微幸福，感恩所拥有的一切，活出属于我的精彩人生	joy
by [PERSON]  白色纱纲頭飾，是、客人從美國訂回來，配上雷絲婚紗、古典優雅！ with Barbie Wu.	joy
 紅包明天我請假親自送你到認養人手上，今天下班後我該準備的認養文，會先準備，有空我也會去桃園市看看你，還有紅包已經改名叫餅乾	joy
觉得对不起大宝贝女儿,因为只是维持0个月母乳而已。母乳是宝宝最好的食物。	joy
 大家早安，好久没吃过古早味的碗仔糕了 	joy
 可爱睡衣套装<0 回乡过年，宝贝的睡衣也是要新新美美的嘛~ ;)可以inbox我询问尺寸哦~	joy
 今天早上给马踢醒了，[PERSON] 对我说你住在我家（马来西亚）！！[PERSON] ，老娘住了几十年了！哈哈．再想想原来约了马年伙计吃来风光点心！马佬细今天马仔等女朋友所以迟到佐！马财神说大马跑了！！！哈哈！再来批马奖，第一马伙计抽到马上去厕所出来就笑口常开，因为马桶有钱拾！第二位了马上脸红红，给马踢了十下！	joy
 【龍錸實業有限公司】年終尾牙訂於000年0月0日星期三晚上0：00～席設：鶯歌區鳳鳴重劃區～歡迎各界先進蒞臨指導～龍錸實業全體員工一同敬邀。。。  at 龍錸實業有限公司.	joy
彼此開始,不愛才會有藉口。以上所有論點可以令愛有了距離及破壞,令一段珍貴的感情及婚姻走向滅亡。所以情侣或伴侶千萬別犯以上幾点。	joy
 師父開示：人生在過程要學會如何去面對.逃避只會讓自己把事情弄的更糟糕。凡事看破想開放下.[PERSON] 其實沒有什麼事情可以難到自己	joy
 兄弟(啊宝)你一定要坚持住,我们一般兄弟会挺你到底,你跟我快点好起来,加油啊!就好像以前[PERSON] 出车祸,你跟他说过的话,你会说[PERSON] ,希望你也会说自己哦!加油	joy
后黑头粉刺都自动献身了好神奇！皮肤红肿用后都好舒服 不会粘粘的期待滑滑的脸蛋〜〜〜〜有兴趣的都可以PM/line我哟大量现货。line：linlinseah	joy
 我們是尚青光電LED廣告，不知道您最近有做促銷活動或想優惠的方案，最近在鳳山建國路&青年路路口有安裝新的電視牆，全天00:00~00:00全時段輪播，已附上托播地點及估價單，提醒您..最新的活動節目為聖誕節^^，感謝您費心看完，謝謝。 承辦人:張專員 手機:0000000000	joy
Good  今天起床想的是旁邊的好姊妹怎麼不見 怎麼沒人掙扎要起床了 噢！原來我們回家了 七天的旅遊 不長但也不短 足夠記得一輩子的回憶 看著照片 突然好想回到泰國繼續玩水繼續逛街繼續拍照 雖然泰國真的很熱很曬很塞 但真的很開心 是因為跟一群最可愛的大學同學一起吧！不過還是要面對現實 工作工作上課上課 各位！！！我們大四了～～～	joy
花收还有提早买的礼物放在一起的呢第三次收到花心情真的是太感动了我老公什么都不厉害 做东做西就最一流了啦不过老公真的太谢谢你了 谢谢你让我也可以很感动的度过情人节我真的真的太爱你了 with Ken Chew. 我的点点滴滴...	joy
It seems really sweet!  在app的料理食譜裡看見的《蜂蜜檸檬汁》進階版!!先用菜瓜布打檸檬外皮洗乾淨，避免農藥殘留，在來把檸檬切片，然後放進乾淨的容器裡，再倒入蜂蜜蓋過檸檬，然後放進冰箱醃0天!到時拿出來加冰開水，就是好喝的蜂蜜檸檬汁嘍～看分享的人說，有瘦小腹和大腿的功效喔！很期待喔～三天後揭曉…	joy
 【管理人生的0個危機】0）不要等到需要，才積累人脈。0）不要等到有時間，才去讀書。0）不要等到身無分文，才想起儲蓄。0）不要等到痛苦，才放下。0）不要等到那個人走了，才珍惜。0）不要等到同齡人都成功了，才知道玩物喪志。0）不要等到變老了，才懂得忘掉。0）不要等到擁有很多時，才學會分享....叫我邱老師.... with...	joy
Amy soo  早安安！平安喜樂！假期舒心愉悦！樂在工作、樂在生活、樂在自我、是一切快樂的來源、只要避免無謂的之競爭和比較、就可以比別人快樂百倍。	joy
 跟媽咪來喝星巴克！ with 湯美雄 	joy
 昨天好開心大家抽空出席Spider的小型聚會^^～今次仲有來自美國、日本的新朋友～搬上樓上鋪的好處是地方比以前大一點～可以約一班朋友上黎食下野、聚腳～如果下次再多人一點就可以租埋隔離party場地,希望大家昨天跟我一樣玩得開心啦～（今晚會放合照的，等我）～ with Dancer Colette and [PERSON] .	joy
。这种感激之情也培养了支持者的忠诚。脱口秀女王[PERSON] 深知对雇员表达感谢的重要性，0000年，她带着所有雇员和他们的家人游览地中海。 	joy
 笑左，將手機最後0個number順住配對，你地又係咩呢？	joy
 社區⋯新景點趕工中⋯藍聰信理事長和一群志工們正加緊趕工，真正是辛苦了⋯ with 藍聰信 and 曾淑照 at 九如[PERSON] 社區.	joy
在溪流之间此起彼落着。快乐的时光总是过得特别快，如今我和堂姐弟们都长大成人了，也有了各自的家庭，只可惜小叔叔在许多年前的一场车祸中离开了我们。华人新年就快到来了，即将来临的除夕夜团圆饭局就是我再次回去祖父家与亲人们团聚的美好时刻啦~！！\( ˆoˆ)/\(ˆoˆ )/I Love My Family	joy
 顾客feedback一星期明显变瘦，瘦得连身边的朋友和家人都有察觉哦~现在减肥的梦想不是难事，garcinia cambogia 0000让您早日实现瘦身梦想 .	joy
 在現實生活中，你和誰在一起的確很重要，甚至能改變你的成長軌跡，決定你的人生成敗。和什麼樣的人在一起，就會有什麼樣的人生。和勤奮的人在一起，你不會懶惰；和積極的人在一起，你不會消沈；與智者同行，你會不同凡響；與高人為伍，你能登上!巔峰。	joy
amazing box )购买现货了哦~我们有卖台湾娱乐圈明星最爱，女人我最大推荐的妆前护肤系列bevy C ，韩国0ce正品化妆品及其他哦~[愉快] 	joy
 天公诞快乐希望今年事事顺利风调雨顺 合家平安	joy
 & 一周每晚睡0小時=連續 00小時沒睡=酒測超標……《醫生這樣說》&長期睡眠不足，使人變得遲鈍、記憶力衰退、判斷力變差、感覺越來越笨、會失去對事物的好奇心；情緒不穩定、容易生氣、憂鬱和焦慮。	joy
 大自然總有股無形的能量,就看自己如何與他互動&挖掘：）在一座小小山谷開心玩耍一陣,意外發現的自然音牆實比目的地的景點更令人驚喜&值得回味^w^ at 武岫農圃.	joy
 各位親愛的大家們。過年漲價公告。祝大家馬年事事如意，馬上有錢！邱馨瑩 [PERSON] 鄭少兒 陳姿姿 范仕勲 范巧又 at 巧曼美髮造型00-0000000.	joy
順心~~~	joy
 原来外国下大雪是多么多么的漂亮，地上还生了0棵美美的树*^o^*	joy
Share,good night to all! Friends  夜色漸漸暗下心緩緩的平靜不知心中的朋友有沒入睡送上我溫馨的祝福洗去你一天的煩惱一句“晚安”送你進夢裡醒來的你會覺得明天會更好朋友們夜安愉快 .	joy
旅遊上的任何需求，～歡迎主動與我連繫～易霖的服務電話：0000000000↓↓↓0000年旅遊相簿↓↓↓，如下↓【一】三月日本賞櫻。【二】四月日本立山黑部。【三】四月泰國潑水節。【四】六月初的俄羅斯。【五】六月底的北疆。☆﹐.‧°*”歡迎大家參與*°‧.﹐☆☆	joy
 謝謝這段時間教導我陪伴我所有演出的你們，還有在台上站很久的你們，真的非常的感謝大家的幫忙 辛苦了。	joy
 立体HelloKitty喵花束〜	joy
中）	joy
易于贯穿肠道以排出体外。此外， BubbleMelt也改进其有效成分的被吸收性质，好让我们身体内的脂肪细胞能够被吸收并进行分解。一盒只需rm000 一套只需rm000^^ 	joy
，把我们的心思意念全然交託，求袮来带领和祝福我们今天所做的每一件事情。愿袮来祝福我们：～平安喜乐，身心灵都健康，福杯满溢，凡事兴盛，恩典不尽。感谢赞美主，奉主耶稣名字求。阿们！ 	joy
吃饭都一样可以瘦*Dswiss Coffee 保证让您瘦，让您美 !! 让您瘦出自信心 ^^有兴趣 PM 我噢 ~♥ 	joy
 去年freshkon得奖回来的colour lens	joy
運動或哺乳和睡覺的時候穿~不建議無時無刻穿會容易下垂和外擴~以上是一些基本的內衣知識跟大家分享一下一部分是我上網找資料看的補充 也歡迎大家分享讓身邊的女生朋友了解關心自己的胸部唷 	joy
Tone Excel，还便宜过你现在用的电话线哦！聪明的你，自己其实可以算一算，哪里一个比较划。这些好处，只需你区区的RM00就可以启动了！你将会得到一张TuneTalk Tone Excel simcard (电话号码，你自己选，可以用回旧号码）Sim card里面还有高达RM00.00，让你Call,SMS,MMS,Online等。。向我联系，开始你的永久事业吧！ .See...	joy
Y  希臘 - 聖托里尼之美夜 Milkyway in Santorini Island, Greece .	joy
 又發現好好用的cc隔離霜有+防曬重點來囉擦起來又超保濕透亮滴 快點++++++++++++Vv0/0要飛韓國囉現在開始接單 with 超人默 	joy
 週末黑皮	joy
能快樂過好年！我開始吃一個星期的素了哈哈，希望所有人都平安幸福(桂桂到[PERSON] 在吃)新年快樂！！  and Niko Liu	joy
 今年要領紅包的人都要說	joy
约定大家到时候见！不见不散！欢迎光临！ at 銅鑼灣 at Causeway Bay Pub & Bistro One Shamelin	joy
 又到一年一度的倫敦折扣季節 summer sales! 搭配 Wolseley 傳統英式早午餐~ what a great way to spend an afternoon 	joy
 最后0支 先到先得 今天汇款 明天交货快快快 PM我向我订购预祝 各位 马到成功 .	joy
位學者發表成為台灣蜻蜓的新成員!!恭喜!!!全文:  	joy
 Milk milk 也来拜个年咯！祝大家：心想事成、龙马精神，身体健康！ with Francis CT Wong.	joy
 有你們這些網友.朋友們真的讓我很開C!!!!! :) 0Q  at 還有很多人 沒標到抱歉.	joy
 訂了新的幾個 台灣 Anyshapes 的電話殻 呵呵 之前的被我弄骯髒了 贊助 或 代言請 私訊 或聯絡For product review, fashion blogging or sponsorships kindly drop me a message or email Follow my instagram @lengyein	joy
Must try  古来帮 红酒水果果冻月饼♥一共有0种水果，kiwi，草莓，荔枝，黄梨，芒果，龙珠果。。。不添加任何色素，颜色完全是红酒的颜色！QQ的，冰冰的，甜甜里带着酒香，非常适合饭后甜品，送礼也非常适合。。。为了保持品质，都是今天接了订单，然后马上做，隔一天出货！欢迎各位询问预定！	joy
 那我就选择初六开工…生意兴隆。。。  	joy
 at 國立林口體育學院	joy
为褐色、灰色、米黄色、红色、白色。0000年忌讳颜色为绿色、青色、蓝色。属猪0000年幸运色 属猪的人0000年的幸运颜色是白色、黑色、蓝色、灰色，忌讳颜色为红色、橙色、黄色。	joy
SD0 + Shake up! Shake Up， Shake shake shake，shake 走你的肥油与耻辱！ 创业家 anna 的分享认识她的人，都知道她瘦身0-0年，但都不是很成功，直到几个月前试喝了 sd 0瘦了 0kg,从00Kg 掉到00kg!!现在又服用 shake up, 不到一星期又瘦了一公斤，腰和手臂加上大腿都小了一圈呢 with Kah Wei and...	joy
別人眼裡，就更有價值。而妳對別人付出太多，自己就會變得更薄弱，妳的利用價值完了，也就完了。所以，別老想著取悅別人，妳越在乎別人，就越卑微。只有取悅自己，並讓別人來取悅妳，才會令妳更有價值。一輩子不長……..記得，對自己好一點。大家晚安！	joy
 给生活一个微笑春有春的温暖～夏有夏的火热[PERSON] 的收获～冬有冬的寒冷学会享受生活～学会要朝前看一切都会变好☆¸.•°*”˜˜”*°•.¸☆ ★ ☆¸.•°*”˜˜”*°•.¸☆ ☆(¯`*•.¸ 平安喜樂. 順心如意 ¸.•*´¯) ☆	joy
 好喜欢当时的景色，佛主，月亮，飞机...形容不出的感觉。就是很喜欢 with Jovin Chan and Yvonne Lee at 东禅寺, Dong Chan Shi Temple.	joy
甘願接受的命運了！今天星期日，美麗好風情，好友[PERSON] ，假日愉快by Britney 	joy
 國泰ETC信用卡，要辦的請與我聯繫	joy
BLOCK 了 ，如有兴趣可以信息或联络这个号码 ：0000000000	joy
 各位好友及十方大德 師兄師姐，想來宣傳世明慈惠堂位於在嘉義縣竹崎鄉 主神無極瑤池西王金母大天尊 簡稱(母娘 王母娘娘),現在在蓋大廟需要很多資金來幫助完成，如果想幫助護持的人可以用劃撥或寄現金袋，金額不限等到廟蓋好會把名字刻在石板上做為永久紀念，最後我不強迫大家 母娘慈悲。	joy
 今天做工不寂寞，还有[PERSON] 	joy
 在博客來0000年買的第一本新書，今天要來開讀囉！	joy
Amy soo  周末送你八个八，事事如意天天发。送你九个九，甜蜜爱情更长久。送你三个三，家人亲人都平安。送你五个五，生活轻松不辛苦！好朋友，小周末快乐！0安吉祥！用餐舒心愉快！ .	joy
 我要訂金得意的0箱（最左上那個）000抽*00包*0袋(00包/一箱)原000變000元一次要訂0箱就是000包(一包不到0.0元)有西港/佳里/麻豆/[PERSON] 的要跟我湊嗎外縣市的也可以找我訂，000就免運寄到家，還貨到付款喔LINE我:meimei0000  	joy
My sister's family～  这次的香港行会选择飞澳门，主要都是要趁机探访经已当澳门媳妇十多年的小姑。。。到步后尝到了美味的潮汕牛肉面，再来个上海晚饭后，就留在家里休息与小姑丈家人小聚。。。明天再过香港与剧组会合，晚上开始拍摄。。。 .	joy
 騎車上宇老，手也僵臉也僵，屁股也裂開，但還年輕的感覺卻是無可取代。這Ps. 這裡的山地同胞操著純正不裝作的口音，全場應該沒有人是清醒的，但卻妙語如珠，每句不是在虧別人就是在虧自己，超好笑的。 at 宇老觀景台.	joy
 跑吧！！00000全馬⋯！！緊張大過於興奮！！只剩0天！！	joy
Good  事情看透彻 你就明白该如何进行~~~~~~~~~~~~~~~~~~人情看透彻 你就明白该如何相处~~~~~~~~~~~~~~~~~~男人只有窮一次 才能看出哪个女人 真心留在你身边~~~~~女人只要丑一次 才能够发现哪个男人最爱你。。。。	joy
珍惜多出來的00天！ 	joy
 吉駿汽車變速箱＾＾歡迎大家多多指教。	joy
 这个可以算是圣诞礼物吗？刚刚突然出现在我家门口，吓了我一跳！还没安装好Raymond就忍不住要下去了！哈哈哈…谢谢你老公❤ with Pan Jok Lam.	joy
HAPPY BIRTHDAY*@*WISH U ALL THE BEST.********  猫头鹰欢乐俱乐部 祝我敬爱的二姐♥0000慧眼鹰KAREN OOI♥生曰快乐♥心想事成♥ 	joy
%来自正庙),将不会提供商业货还是假货还是制作货给大家。如何都好，本人在此谢谢一直以来支持本佛行的大家鞠躬感恩与感谢，如有任何问题，大家可以直接联络本人，本人将无穷的欢迎大家。谢谢您们 	joy
 今天孤挺花全開心情好、紅、白仙子從初一開到現在、、、、、高興。,--	joy
 好美的圣诞夜景♥朋友们晚安哦O(∩_∩)O GOOD NITE	joy
 我是女同，我为自己代言你只看到我是同性恋，却没有看到女人间的真爱；你有你异性恋的平坦大道，我有我同性恋的别样风景；你嘲笑我是变态，我可怜你没文化真可怕；你否定我的真 爱，我说你只不过有后代。蕾丝，是注定曲折的美丽。有质疑，有责难，但，那又怎样？哪怕遍体鳞伤，也要坚持自己。我是女同，我为自己代言。	joy
Happy Family  毛哥~從馬來西亞來了 今晚吃喝玩樂幫又聚在一起了^^ 來吃毛哥滴最愛~火鍋兒~ ┏┓┏┳━━┳━┳━┳┓┏┓　 ┃┗┛┃━━┃━┃━┃┗┛┃ ┃┏┓┃┏┓┃┏┫┏┻┓┏┛ ┗┛┗┻┛┗┻┛┗ night♡ with George Chun and [PERSON] .	joy
 走了四年的红地毯, 每一年的感想都不一样, 年年喝彩年年高升, 未来的精彩等着你我共同创造。我是♡Angie Oriana♡,♪向挚友们问安 ☆♡ 感恩有你 ♡ 感恩一切.	joy
国际品牌如三星,P&G,L'Oréal,及 Unilever等。这个奖项已经有在00个国家和00年的记录。 	joy
 *牛沒奶*早安朋友~世界上所有不圓滿的結果,他終究是一件圓滿的事情。。。	joy
 投票囉！！ (一人一票) .	joy
[PERSON] Li  親 <0 愛的好朋友 ！早安安！小週未愉悅我們說過的話，做過的事，走過的路，遇過的人，每一個現在，都是我們以後的回憶。無須緬懷昨天，不必奢望明天，只要認真過好每個今天。說能說的話，做可做的事，走該走的路，見想見的人。腳踏實地，不漠視，不虛度，有緣無緣，一切隨緣，就算心碎也要擁有最美的姿態。	joy
OMGFinally IN N OUT is coming!!!!!!  加州最受歡迎漢堡！ IN-N-OUT進軍台灣 !!台北市光復南路000巷00號這應該是0000最好的消息	joy
熱鬧網址:  at 下蚶普庵壇	joy
good!!  男人，要么就高傲的单身，要么恋爱到结婚！何必浪费自己的青春！去养别人的老婆，还那么认真！	joy
 哇…爱人送的礼物	joy
 无聊的我，哈哈哈	joy
，美味的菜肴也可以吃了~恭喜您，健康美味午餐速成，自己做的饭就是不一样，吃得也很放心。欢迎零售及批发询问.....有兴趣的亲亲们可以留言	joy
更偉大的行動！萬事都要為此效力！祂必要堅固我們，祂是信實的，祂召我們來，要與[PERSON] 一同得分。祂一定會成全，因為最軟弱小羊也不會脫祂的手！。阿們(0◕ܫ◕0)【溪水旁網路福音書房】	joy
You too.:)  端午節要到了，面對著美味肉粽，你是否擔心自己的體重跟近年來肉粽的價格一樣直線飆漲呢？送上我的最新文章《享粽，不變重！》，希望大家度過一個愉快的端午節！	joy
 迟了报道....新婚快乐	joy
喔， 想要大太陽， 大家要來喔 !! .By: 花茉莉超人氣活動主持*~[PERSON] Alice~*就是愛主持℃ 台北 ℃ 愛麗絲0000年最後一場在台北的公開活動就是今天了!!!接下來我們要在北部見面的機會就是0000年囉~~ \(^▽^)/ 日期：00/00(星期六) 今天！！ (´⊙ω⊙`) 活動時間...	joy
见面复制以上就能成功！重要条件加入：0.必须00岁以上0.拥有马来西亚ic/国际护照/难民卡0.拥有马来西亚bank恭喜你成功 . 0000 0000000 david ng...	joy
借~~就這樣愈陷愈深而無法自拔。。這種行為實在很愚蠢~~人生其他方面也都是如此。。如果自己不是別人的對手~~已經全盤皆輸。。不可能挽回局面時。。就不要再陷下去了~~此時應該趕快撤退。。就算輸掉了也無所謂~~只要能以此為戒。。學到經驗就夠了~~這就是對自己慈悲。。滿足目前所擁有~~	joy
 帶著 @皇家貴族足體養身會館 眾仙女ㄉ愛心 物資 探視弱勢失依兒兒童館 青年館興建中。。希望善心人士投入協助	joy
 光靠外力，不努力磨練自己，不可能會有喜悅。幸福不是靠誰賜予的，不是他人帶來的，而是靠自己爭取的。因此只有自己努力成長，充分發揮自己之外，別無幸福之道。充分發揮自己潛能，茁壯成長而得到幸福才是真實的。  at 台北市000 观景台 Observatory.	joy
 放假到氣球展走走，是你最好的選擇！旋轉木馬改成旋轉麋鹿～實在是太可愛太有創意囉！滿滿的聖誕節的氣息＾＿＾ at 氣球展.	joy
00000000000 泰国号码: +00000000000 （00/00/0000 --- 00/00/0000)有任何详情可以请联络本人泰国号码欲参加法事者请按以下链接师傅已经肯定什么时间过来了哦 	joy
 人生的路，好與不好都要走過，無論坎坷，還是平坦，無論順利，還是棘手，一些路，一些事，總要自己面對與成長……	joy
；你的生命才有價值，你也才永遠被尊敬。	joy
的祝福。祝愿我FB的所有朋友幸福快乐。	joy
 0000年00月00日（星期六）晚上0时00分，峨仑佛教会最后一场，《真善美的旋律》音乐会~一张票只需RM0而已，有兴趣的可以向我索票或inbox Ng Jia YiPS:你可以路过，可以经过~但，千万别错过!!!!!!!! :D	joy
 [PERSON] 上衣 last piece ~高腰裤 size - S / M ~有兴趣者快来PM我吧 ♥	joy
Penny is getting ready for her forever home in US :)  今日任務：拯救妞妞小黑媽媽，很乖的小孩，很幸運的0合一通過了，但是月經來所以發燒了！這段日子妳辛苦了，接下來就是去幸福的家了！good luck妞妞 .	joy
 有人問[PERSON] ：喜歡與愛有什麼區別？[PERSON] 指了指一個孩子，只見他站在花前，被花的美麗迷醉，不由的伸出手把花摘下來，[PERSON] 說，這就是喜歡。接著[PERSON] 指著指另一個男孩，只見他滿頭大汗的在給花澆水，又擔心花被烈日曬著，自己站在花前擋光，上帝說這就是愛。喜歡是為了得到，而愛卻是付出。	joy
come together  今天是黑色情人节，单身的男女朋友想要来结交多一些朋友就来参加我们的party吧！地点在PD waterfront （Box Story）还有很多节目等着您！祝大家黑色情人节愉快	joy
 新款卡通保护膜上架咯...快来选购哦... 	joy
 真性情的洪大姐 .敢言、只做對的事.全力支持她參選屏縣議員為民服務衝衝衝~加油!!	joy
 今日是鮮豔低” red monday”！！歡樂的聖誕前夕，吃到好多美味家常菜好滿足哦 <0<0~~and交換禮物抽到一瓶00年三得利威士忌，可以好好的乾一杯了haha~~I like it。	joy
 晚飯台湾商視察(江陰毛紡織廠)來到大門口霓虹燈的廠名前，不巧電路故障，第一個	joy
Just visiting... #ktm #xbow #ktmxbow #overdrive_pg  坐在那么smart的跑车上，我显得更加渺小…  	joy
Thanks mom ,happy mother's day!Mat000-Milly  歡迎小朋友踴躍參與母親節徵文活動~成功上傳照片及留言者可獲得點數00點喔!	joy
~改善夜尿，频尿及小便无力 ~平衡内分沁系统 ~尿酸问题 ~前列腺肿大 ~改善糖尿病 ，胆固醇 ~提升男性性能力，无法勃起 ~男性早泄，不育 ~提升精子的品质 ~改善睡眠，消除疲劳 E000肯定是你最佳选择..! 快快联系我吧~000-0000000 WeChat~ 合格代理。。my00000000 专业区@...V0~E000~	joy
 这是我一路以来坚持的理由！ 分享给正在打拼的人， 一定要一起加油 拼到底 晚安咯！ 	joy
 新春期間，許多人會選擇出國旅遊，防疫小提醒告訴你，[PERSON] 大家新春愉快!	joy
 明天就過年了，先向你拜個早年，在此恭祝你和你的家人：除夕㊗團聚香甜初一㊗喜慶新春初二㊗富貴滿堂初三✨㊗福慧雙增✨初四㊗大吉大利初五㊗滿載而歸初六㊗春風滿面初七㊗天天快樂初八㊗福祿壽存⛲初九㊗如意吉祥初十㊗萬事亨通十一㊗一帆風順 十二㊗吉星高照十三㊗全家和樂十四㊗身心安康元宵㊗鴻圖大展	joy
 加班中…只要您喜欢。幸运儿稍等哦^_^	joy
 我在跟我姐姐比赛你们谁要知道就按赞 with Weng Chin.	joy
Any Maltese fan???  麻麻在大掃除 我們有乖乖哦	joy
 又是一年美好的开始，又是一段幸福的时光，又一次真诚地祝福你：马年快乐，万事大吉！祝你春风得意马蹄疾，新年伊始，愿你乘着和煦的春风，朝着灿烂的前景，马不停蹄、奔腾捷进！	joy
 不管是好的、壞的，收穫滿滿還是傷心失望的，0000這一年都即將劃上句點；讓我們一起來迎接這嶄新的0000！在此預祝大家新年快樂^^來年荷包滿滿。	joy
．  原始点医学讨论区（新加坡） Origin Point Medicine (Singapore) 这位长者是学校食堂工人,六十多歲没兒女亲人,长居一间廟宇,大概两个月前经朋友介绍前来找我,描述説腰部和双脚疼痛,经西医和針炙也不见疗效,经原始点治疗和改飲食也温敷及服用姜湯,現在已经達到[PERSON] 的缓解...	joy
 lets go traning  at 香港國際機場一號客運大樓 Hong Kong International Airport Terminal 0.	joy
 政府給你RM000，kangkung一把RM0，每天吃一把，一年才RM000，還剩下RM000，狗米00公斤的一包平均RM00，以個人計算，平均兩個月吃一包，剩下的錢，剛好你可以買0包，夠你吃一年了哦！還有RM0讓你去買調味料呢！所以那隻雞說RM000可以用一年哦！我觉得很有道理就转发了~	joy
 機場駕照拿到了，可以在機場穿梭自如，嘿嘿。 at 桃園國際機場第二航廈.	joy
的人，但現在要找到沒有心機又不會亂罵髒話的年輕人大學生，實在是少的可憐……以我的角度，我可以隨波，但我不會逐流，很多認識我的人都說我很可愛，什麼叫可愛？單純、沒有心機、敢秀敢跳、不在意別人的評論，這就是（可愛）！希望大家一起來學可愛喔，啾咪！  at 濟興長青園	joy
 歲次甲午年000年嘉邑佛緣宮恭祝伏虎濟公活佛聖誕千秋暨天上聖母徒步北港朝天宮進香系列活動～歡迎各位善信大德踴躍報名參加＠＠一起跟我們體驗一下白沙屯媽祖的魅力吧！！嘉邑佛緣宮管理委員會敬邀～～電話：00－0000000地址：嘉義市文雅街00巷00號 at 佛緣宮.	joy
 今天是Loh Bee Hong煮的丰富午餐	joy
 蘭花生態寫真 Ctna. - Why Not Sanguinea	joy
)（你的一点是我们的一大点。）若有任何机构/NGO/社团想要参与或筹款等等，你们可以联络我 Lobin（000-0000000）或我的母亲[PERSON] ）我们可以给你更多详情以及有关资料。也希望看着这篇文章的你，做一些小小爱心，帮助我们。将这篇文章宣传出去，让更多的人看到也能和拥有爱心的你一样给我们帮助。谢谢大家。	sadness
forward pl  [PERSON] 狗會學習營 唔該大家幫手留意下，主人好擔心，已走失多天	sadness
pls share and help......  肇事者，最好你保佑，今天她會清醒，否則你所有的言語，都將成為，呈堂供詞。親愛的媽：醒來吧！求求妳……有誰看到，或有行車記錄可提供，拜託，幫幫忙，在新竹中華路、經國路口，時間是0/00，下午0點左右，請有路過此地，目睹者與我聯絡，[PERSON] 小姐 ，謝謝！	sadness
 为什么要把树木砍掉，马来西亚已经很少大自然了。地球也生病了。为了起房屋就牺牲大自然 	sadness
 【前线分享】元旦倒数活动地点！特别提醒：今年金三角金河广场没有音乐倒数派对！	sadness
 是吗？骗人的 我之前发脾气 你都很迁就我 现在他鸟我都傻 我生气第二天就会带我上云顶 现在我生气就带我回家那里都没去了 good	sadness
，現在也只好靠著網路的便利及大家的愛心，幫助我們幫助伍阿姨更幫助那些可憐無辜的狗狗還有貓咪，阿姨甚至連烏龜鴿子都有救，很有愛心吧!你們可不可以幫忙阿姨捐點衣服，罐頭，報紙，或者能力範圍可以的金錢都可以，拜託大家!拜託謝謝 	sadness
 怪不得每年过年都肥了,今年一定要好好控制,我的减肥黄金三个月要过去了,才瘦0kg	sadness
...的报应！家里又少了一只狗，再也听不到它大声吠的声音了！Popeye我们都爱你，你要乖乖的去找天使姐姐哦。	sadness
 機車老闆娘好變態！！！每次跟她男朋友吵架就來罵我們，同事頂嘴就被罵哭了！我好可憐！不敢頂嘴也不敢哭，強忍著晚上一個人躲被窩慢慢哭吧！	sadness
Happy happy you  这几天很不开心,我 fb出了问题很怕很怕在也找不到你们了。。。还好今天我的嫂子帮我找到了我的fb,,,嫂子谢谢你。。。网上好友午安幸福快乐,,,恩恩好想你们噢。。。	sadness
 這陣子老公外地工作都不在家，又得知下週得外派國外出差一個月後我整個心情很鬱卒啊！連過年都沒辦法陪伴家人這真的很不通情達理……這孩子剛在睡前問了我媽咪：為何爸爸都不回來呀？我：…………沒辦法要工作他還不知道即將又要一個月看不到爸爸的感覺	sadness
Pearlynn Wong  因为你我今天迟到了～哎哟哟～可怜的司机～不知道有没有事 	sadness
 這是過敏鼻子的心聲啦!	sadness
Cash Chen  帮忙SHARE出去，大骗子！！	sadness
Same.....  每家人都有一個故事。	sadness
开，要等放工才可以把车子移开。（半小时后）下来把我的车拍照，我只是向前问为什么把车拍照起来?他就问我是否担当得起他客户没有车位parking的kos,如果没有就要他的supervisor把车子停在那里，0个小时后才会移开!!直到我男朋友来了之后才了事。（我其实知道自己有错在先。只是不明白的是，为什么可以这样不友善，大家都是华人，需要这样只解决事情吗?) ...	sadness
 0月0 更新 狗狗以經被主人帶回了 感覺像有人養的 但沒戴項圈 感覺在找主人 看到每個人都噗過去聞一下 問了麵攤老板 老板說今天早上才看到牠在這 毛蠻整齊只是下雨髒了 是公犬 在基隆 西定路這邊 是誰家到毛孩啊 ... 牠感覺餓昏了 吃了三片土ㄙ兩個罐頭 或有沒有人想養的呢 蠻溫馴的 幫忙分享好嗎 謝謝 ...	sadness
！><☆延伸閱讀／[PERSON] 小孩救援現況： at 大葉高島屋 Dayeh-Takashimaya	sadness
[PERSON] ，可能只夠買一套衣服和吃一餐熱飯。K想問眾人聯絡方法；對不起，他們無手提電話。或許，這是最後一次聯絡/見面。緣散。抱著囡囡看這幅圖，告訴她發生什麼事，我只可以說﹕「我地好幸福！」 	sadness
my bro, him unhppy  為什麼沒有人理解我感覺我們為何的人誰我 愛是不明白我的感受嗎？現在我失去了一切。家人，我的愛，總是理解我也失去了。為什麼我還活在這個世界上？誰可以明白這一點的感覺？Nek Nas Oun Tra Meas Bong!	sadness
消息傳出去，首先感謝大家的幫忙。最後感謝你們的細閱和支持。------------------------------------------------------------------------------------------------- with Augustine Lee	sadness
 今天小年夜，無聊的朋友可以來找我喝一杯~錢錢，不知道你現在在哪裡有沒有被虐待…有沒有吃飽會不會冷……媽咪想你拜託龍潭的朋友幫我注意一下謝謝大家了T_T 	sadness
so sad 00+++ year  大年初一	sadness
，而两名成员先后受伤，令Fans们十分担心明天的演出。	sadness
眾人。小量現金，可能只夠買一套衣服和吃一餐熱飯。K想問眾人聯絡方法；對不起，他們無手提電話。或許，這是最後一次聯絡/見面。緣散。抱著囡囡看這幅圖，告訴她發生什麼事，我只可以說﹕「我地好幸福！」 	sadness
 urban decay naked0好评，可惜现在缺货有客人没有货	sadness
 心好寒喔！真心的對待朋友，換來的卻是～被判及出賣…和說一些無中生有的言語，並波及到~我現身邊最親密的人，難道…這世上的友情/愛情，都是假的， 現真的怕怕了，真不知…是否要再相信人心了，不管是友情或是愛情？我真的不知是否要再相信…真正的友情，及不變的愛情ㄚ！被人～被判，出賣及欺騙…心情真的很差，很心寒。 at 鶯歌	sadness
,他们才能认真积极,所以, 选择让其他有专业水准的裁判组织执法也是另一促使篮总裁判组改过的途径 。0)篮总会长与体育理事会必须正视这一问题!因为篮总在篮坛的权力太大了,没有任何的组织有能力干与它的行政与行事方式,一些问题往往是被蓋着不惊动最高层去解决!!!我们吁请会长与体理会,教育部正视这一问题,解决它还我篮坛一片净土。谢谢 with 篮球裁判 and 0...	sadness
R.I.P  哀悼...永别了~马来西亚的民主斗士.致敬的 KAPAL SINGH 一场严重车祸而不幸逝世	sadness
 狗狗認養 有愛心聯誼網 【搶救！搶救！！】跪求‧乞求哥哥‧姐姐‧大叔‧大嬸們：緊急搶救支援，幫助受很嚴重的小孩嗎？五分鐘前在柳營的五分車鐵軌上看到的。被補獸夾夾到，感恩。轉po朋友的文章。因為我們都住在台北市。 at 大葉高島屋 Dayeh-Takashimaya.	sadness
Yeah... media blocked.  你们开面书视频的时候，是不是也一样打开不到？出现如图片中的这情形？难道大马政府封掉大马网络？禁止我们在面书观看视频吗？	sadness
 今晚看到很多人都在放孔明灯祈福。其实大家知不知道放孔明灯会造成空气污染，一不小心会造成火灾，影响飞机飞行，停电等等的坏处？祈福的方式有很多种，不一定要放孔明灯啊~希望大家今晚不要再放孔明灯了。请大家转发以让更多人知道放孔明灯对环境真的很不好。感恩。	sadness
Salute to my favourite England Team ♡  意大利输球后，最喜爱的英格兰球队，今夜正式道别巴西 Bye Brazil.....	sadness
出現~~~小美女!一路好走,!不用留戀!懂嘛!!對不起!!!我們來遲了!!!對不起! with 戴平安 and Mozart Lu	sadness
RIP  安息吧，波仔。	sadness
please help 有人可以給他一個家嗎？剛剛在旺角愛護動物領養中心看倒他jack....被主人在00/0遺棄了。希望大家share 出去幫手替他找個家。看倒他好唔開心個樣灰哂。如果想領養請自行到旺角領養中心查詢	sadness
大餐給你吃，快點回家了不要讓我們擔心。 	sadness
 他就去快活，我就顾孩子，心理不平衡了．．． with Sang Yeng and Jessica Chye.	sadness
，正在逐漸康復中，目前仍由台灣動物緊急救援小組安排住院中。如果您想要幫助這隻可憐半臉狗的醫療、安置等費用，可上台灣動物緊急救援小組網站：  加入捐助行列！ at 大葉高島屋 Dayeh-Takashimaya	sadness
，什麼才是最值得你擁有的幸福。聖嚴法師曾說，他的一生，就是許願和還願的過程。這句隱隱透露謙遜及對世間慈愛的話語，深深感動了許多人。宗教家的願望，是希望人人都過得幸福。而我們一般人的願望，也總是離不開自己理想中的幸福人生︰或許是富裕的環境，或許是事業、感情與人際關係的成功圓滿，也或許是家人的健康和無憂無慮的笑容…而我呢？是什麼？	sadness
Bull shit!!Past Tense...... :(  承諾 ?做不到根本就是個屁 別說感覺沒了 直說不愛了 !!!什麼都可以拖拖拉拉只有感情事一定要分清楚給所有人一句話不愛記得請早說別演累了自己 騙了其他人 淚 了 那 個 深 愛 你 的 他 / 她 __ <0	sadness
 漫长的假期差不多要结束了	sadness
Puppies for adoption...  有谁要领养流浪的小狗。姓别：母 地址： E-00-00,jalan EJ0/0.taman ehsan jaya,00000 johor bahru，电话：要养的直接打给我0000000000他们很可怜 	sadness
 ♥ 有愛認養 不離不棄♥ 【搶救！搶救！！】跪求‧乞求哥哥‧姐姐‧大叔‧大嬸們：緊急搶救支援，幫助受很嚴重的小孩嗎？五分鐘前在柳營的五分車鐵軌上看到的。被補獸夾夾到，感恩。轉po朋友的文章。因為我們都住在台北市。 at 大葉高島屋 Dayeh-Takashimaya.	sadness
 高雄 寵物 失蹤.認養 專區...限高雄 拜託大家在仁武八卦一帶有看到她救救她~我家的的狗不見了!她名叫包子~眼睛有障礙也很溫馴~家人非常擔心她!!希望有心人看到她馬上通知!	sadness
 狗狗認養 有愛心聯誼網 【搶救！搶救！！】跪求，乞求哥哥，姐姐們：這隻小狗狗是在台中市立火葬場的[PERSON] 小孩，背後不知道怎麼了，躺在地上奄奄一息⋯⋯有誰能救救牠，這是無辜的小生命，誰能幫幫牠？ at 天母運動公園法式滾球場.	sadness
 国保想剥夺匡匡的辩护律师，这是赶尽杀绝的架势	sadness
剛好是台北市寒流來襲時！0個月大的幼犬該如何渡過寒流和大雨？（因為那時候剛好撿到黑爺爺，所以很確定！ 那幾天台北市都是很冷很冷又下雨的⋯）雖然知道錯過黃金時間了！但是還是希望把孩子找回來!望大家分享轉發⋯感恩⋯ with Amy Yang at 躺在三小的床上	sadness
If u found it pls inform...  我知道找不回了不过各位关丹电话店如果有收到一架note0灰色新加坡机GT-N0000 请联络我。很稀有大概GT N0000应该是没有几架。拿了我电话的人麻烦给回我你要钱我给你电话麻烦还我，这电话是我生日朋友送我里面东西和电话对我很重要.麻烦各位了	sadness
Say  刚和老公通完电话，眼睛情不自禁的掉泪，现在的心情是多么的低落。既然已经发生了，大家就要坚强去面对一切！ with Tan Chun Loong.	sadness
 有女朋友好像等于没有。朋友又全部不理我。一个人喝酒好寂寞啊	sadness
 貓狗救援福利再站^^ 【搶救！搶救！！】跪求，乞求哥哥，姐姐們：這隻小狗狗是在台中市立火葬場的[PERSON] 小孩，背後不知道怎麼了，躺在地上奄奄一息⋯⋯有誰能救救牠，這是無辜的小生命，誰能幫幫牠？ at 天母運動公園法式滾球場.	sadness
（接下頁）-----------承辦單位(電話0000) 審 核 決 行 本表視同命令，自000年0月00日（星期二）起生效，請依規定辦理離到職手續上列文件請註記轉發上開通知表列單位及人員副本抄發：本分局內勤各單位(長官這些公文是假的嗎?上面不知道是什麼?)	sadness
及早筹得医药费，她将剩下几个月的生命。可怜的孩子。。。。详情请看以下的信件。请大家慷慨解囊，多多益善。功德无量，谢谢！请各位善心人士帮帮忙！帮忙分享！ 	sadness
⋯⋯⋯⋯⋯  請肉搜這台車！狗狗的腳跑到流血了！	sadness
你们有谁觉得他的儿子连畜.生都不如的，就转下去让更多的人看看！	sadness
也(Subang)管制中心失去联系,飞机没有和越南空管联系。 	sadness
孩子對不起,我們來遲了! 網路大家給你取名,飛燕，貴妃,小可愛,排骨,饅頭~~~在我心裡,我想叫你為(奇蹟)我盼望奇蹟會出現!!!然而!!!奇蹟還是沒能出現~~~小美女!一路好走,!不用留戀!懂嘛!!對不起!!!我們來遲了!!!對不起! with 戴平安 and Mozart Lu	sadness
Lol  我的妈吖为什么做错一题就fail了	sadness
 什么才是真愛？肯德基内 两位白發蒼蒼的老人[PERSON] 筷子夾了雞腿對阿婆説“雞腿好吃 你吃吧 我吃薯条就行啦”阿婆回答你自己吃啦 我又没有牙齒 能夠每天陪著你 我吃薯条已經好满足了感動。已哭了	sadness
R.I.P  听到这个消息～觉得人生真的很无常 也许是命运在做弄或许是注定 所以一定要珍惜还活在世界的我们～R.l.P	sadness
修建家族塔寺 老二、三不願將來入寺於是反對將遺產用於修建家族塔 遺產分配老二、三的條件是老大將告別式費用補齊遺產再來分配如果您是老大，怎麼做？	sadness
 啊公，今天是第四天你离开了我们，明天你将正式的离开我们入土为安了。。。明天不能送你最后一程，只能送你离开家门。。。你慈祥的脸孔将永远刻在我们的心里。。啊公，有啊嫲在天国等待着你，你不会寂寞，安心的去吧！永远怀念你的子孙们（同泣敬）	sadness
thanks wu  我用冷淡的外表掩饰我内心的伤痛，这种滋味，谁能理解...我不恨谁，也不敢恨谁，因为我没资格恨谁...	sadness
:標注到的好朋友們抱歉,因為你們是我最想告知跟請求幫忙的人,請幫我轉PO,或有其他建議跟教導也請告知我!!感激不盡~若有困擾僅可刪除並至上歉意~ . 要分享請點讚~再轉分享~否則一率封鎖!...	sadness
RIPIreen Tan Kui Lin [PERSON] 佩 [PERSON]  恩爱夫妻就这样走了,可怜	sadness
 OMG！我们的paul walker…永远会记得你所拍的戏…RIP安息吧…	sadness
[PERSON] I miss you forever ~  老表，很吾舍得妳的离开但要面对时实，願妳在天国安息吧！^^^一路好走^^^ .	sadness
 害怕出社會的我。。	sadness
Liked this  出发去机场 再见了	sadness
乾糧》我們急需您伸出援手請幫我們一大家子能安然的渡過這寒冷的冬天好嗎？？？謝謝您們！~~ at 天母運動公園法式滾球場	sadness
 大家晚安如意！~~~~ 某個村莊傳聞將有山賊來襲, 村民個個做好防禦 準備, 並將村裡 的年輕女孩都藏在山洞裡, 以免受到山賊的淩 辱。 正在慌亂之際, 突然看到一名老太婆匆匆忙忙地 往山洞裡鑽。 『阿婆, 您年紀這麼大了, 大可不必跑來避難 的。』 老太婆忿忿地說:『山賊也有老的吧 ! 』	sadness
難考在於監評不讓你過，你怎樣就過不了！晚上知道不及格後我會查成績，要刷我要給我一個好理由，因為我無力再考一次了。	sadness
 出發前往日本 二個病號小孩要開學再見面了	sadness
那麼普通，那麼普通的虎斑貓，和你我有一樣普通的感情。這就是我愛牠，我想牠，我珍惜牠的地方。	sadness
R.I.P  RIP:-(,下一秒会发生什么事，我们谁也不知道，唯有珍惜和知足才会对得起自己今生没白来这世界了>_< with Sam Cks.	sadness
 难得出坡一粒爆胎一粒漏风还好轮胎店有开  	sadness
 與其跟別人批評誰的不是不如拿別人的缺點檢視自己一直講只是讓別人拿放大鏡看你罷了！	sadness
 金包里慈護宮拆除重建建築歷史年齡與我們記憶故事即將重新寫起[PERSON] ＂[PERSON] ＂為朋友我們一同來關心我的的大廟│金包里慈護宮│ at 金包里慈護宮.	sadness
To those near melaka friends if saw this puppy pls contact the owner.  博美狗失踪，在早上刚在[PERSON] Melaka Raya post office 附近失踪，巧克力色，0.0kg，过胖，没有门牙，舌头都伸出来，颈项有黄色项圈铃铛，谁有看见可以向我们联络，00000000000谢谢 ...	sadness
昨天無法去真遺憾	sadness
＠_＠  過去的－別再遺憾…未來的－無須憂慮～現在的－加倍珍惜！！ . [PERSON] 	sadness
Rip  看到上面的新闻已经觉得很心酸了.....不久却在网上看到 Eric Tee 的消息...真的是让人心痛....祝你一路走好....R.I.P..	sadness
我们都爱你，你要乖乖的去找天使姐姐哦。	sadness
 分開後，我還認識你，不過不再想見你，你過的好，我不會祝福你，你過的不好，我也不會嘲笑你，因為我們從此陌生，你的世界不再有我，我的世界不再有你。我不能再珍惜你，抱歉，我失去的，也是你失去的。我的難過自己才懂。	sadness
RIP  Rip...不会忘记童年时代你给过我们的欢乐	sadness
 在这个世界里是不是已经找不到一个真正的爱情。我想我不会遇到了的。现在的人对爱情的观念太随便了。古语说的得对：男不坏女不爱。女不坏男不爱。好的往往是受伤害的那个。	sadness
保佑著大家健康平安，不管發生什麼事，HBT十六位永遠存在 	sadness
OMG !!  香港报纸…我无言了！	sadness
 一生要哭多少回，才能不流泪；一生要流多少泪，才能不心碎。我眼角眉梢的憔悴，没有人看得会；当初的誓言太完美，像落花满天飞。冷冷的夜里北风吹，找不到人安慰；当初的誓言太完美，让相思化成灰。	sadness
 一场意外，造成一家人的负担 at Putra Specialist Hospital Batu Pahat.	sadness
Share  Jan Jan 昨天中午在大帽山川龍村走失，至今尚未回家，我們實在很擔心，希望Jan Jan平安歸來!	sadness
My brother  前幾天，它讓我明白了一些原因。事實上，你準備好離開。但它是我的錯，我不承認現實。如果你認為這是好事，你可以選擇任何選擇。它類似於我的選擇，正等著你。	sadness
 警察北北拿來的通緝單麻煩大家協尋一下…特徵~胸口有咬毛 with 陳以杰.	sadness
心，难道你就是这样回报父亲的吗? 人生短短数年，有生之年，我愿用我十年的光阴，换来父亲的长寿。 但看了这老人，真的很心寒，如果你们有谁觉得他的儿子连畜.生都不如的，就转下去让更多的人看看！	sadness
 歐聯00強抽籤結果.....[PERSON] 對巴塞隆拿.....	sadness
 可怜的弟弟挂彩了！	sadness
Wtf? Got psycho here in Macau?  浪浪義工團 台山聖約瑟第五校附近！出現殺貓人士！應該是在凌晨出動！家人在前幾天放狗看到一隻白色貓死了，沒了雙腳，起初以為是比車撞死，但今天早上又發現了一隻死了既貓貓，牠無左一隻後腿，所以肯定是被殺的！	sadness
是不通情達理；明知道[PERSON] 險不可前往，我們也不會貿然出團，因為出事我們要處理的比現在這些瑣碎的事情還要多；我們也不會想發災難財，我們忙東做西的，紅色警戒扣除必要費用還不都要全額退費(僅橙色可收[PERSON] 服務費)。---有做泰國路線的旅行社好朋友，大家辛苦了!!	sadness
的。这是一個新的打劫伎倆，上個星期五有人看見過他們用同樣的手法在USJ那帶出現，昨天也在Dataran Prima出現。大家一定要小心！尤其是女士，同情歸同情，也要注意本身的安全。	sadness
」《我們急需乾糧》我們急需您伸出援手請幫我們一大家子能安然的渡過這寒冷的冬天好嗎？？？謝謝您們！~~ at 天母運動公園法式滾球場	sadness
消防隊、幫幫牠儘快拿掉捕鼠器！拜託了。。麻煩幫忙分享！謝謝大家！	sadness
looper  莎莎的粉絲專頁人氣少的可憐，讓莎莎好難過阿~你們偷懶沒去[PERSON] 加入粉絲專頁對不對 這樣不行哦 (已哭)快點去幫莎莎專頁衝衝人氣吧!!!	sadness
逐漸康復中，目前仍由台灣動物緊急救援小組安排住院中。如果您想要幫助這隻可憐半臉狗的醫療、安置等費用，可上台灣動物緊急救援小組網站：  加入捐助行列！ at 大葉高島屋 Dayeh-Takashimaya	sadness
了什麼事？或許有您的苦衷。我想，狗狗的生命很短，如果能夠，看在牠一直在等您的份上，您能回來帶走它照顧牠到終老嗎？很快照顧牠幾年時間就過去了，牠也會老死走掉的。但牠會一輩子感謝您，對您忠心到老。讓牠這輩子能很快樂的離開。拜託您了。 台中國產金獎住戶 [PERSON] 。寫於 0000.0.00 at 國產金獎	sadness
）或我的母亲[PERSON] ）我们可以给你更多详情以及有关资料。也希望看着这篇文章的你，做一些小小爱心，帮助我们。将这篇文章宣传出去，让更多的人看到也能和拥有爱心的你一样给我们帮助。谢谢大家。	sadness
raja mohan愿您在天国过得快乐 愿你在天国照亮您的家人我会永远记着你	sadness
记得你的话！您要我们写给您的歌曲~我们会完成。。。希望您在黄泉路上安息。。。 	sadness
 你很好，是我不適合...。你很溫柔，是我太笨拙。你很善解人意，是我配不上。我什麼都沒有，沒有年收入破百。我什麼都沒有，沒有迷人的外表。我什麼都沒有，沒有可以天天陪你的時間。對不起...你適合更好的......	sadness
/BuySafe_EZ.aspx?web=b0000000000.慈音園購地專戶 彰化銀行代號：000帳號：0000-00-00000-0-00 戶名：新北市保護動[PERSON] ** 愛心幫助後請告訴我們 後五碼 / 金額 / 姓名 / 住址 / 用途 ，以利開立收據，謝謝 	sadness
wtf..........  請肉搜這台車！狗狗的腳跑到流血了！	sadness
.savedogs.org/donation/ 加入捐助行列！也請幫忙轉貼分享，讓大家一起串聯集氣為小黑加油打氣喔… at 天母運動公園法式滾球場	sadness
This is Taiwan black bear , only 000 No. Is left today !  (黑熊)是台灣的國寶為什麼不注重牠新聞都是黃色小鴨 熊貓怎麼不報導台灣(黑熊)台灣媒體請多關心自己的國家小黑熊(黑糖)也非常可愛 也很萌的請多分享出去	sadness
RIP  人生无常，他走了。还记得在0000年0月回到至今，还有00天我们相处将近0年，您总是给予我最大的鼓励及发挥的空间，虽然今天您不告而别，但在我的心中，您永远是我们光华采访部的“第一”，愿您一路走好！	sadness
燭光那怕是再微弱黑暗中一樣能溫暖人心	sadness
 爸剛長眠安定靈骨塔一個禮拜看了爸好心好捨不得.回台南邊開車邊哭著心想明年不再過生日	sadness
 誰能告訴Haha 為什麼acer筆電那麼愛更新 更新後卻又更爛更慢!!!(砸爆它好了)今晚晚安圖 (好久沒有斜劉海>///<) 衣服 (周日登場) yabe~晚安 with 搞怪甜心〃hahaの粉絲團.	sadness
文章的你，做一些小小爱心，帮助我们。将这篇文章宣传出去，让更多的人看到也能和拥有爱心的你一样给我们帮助。谢谢大家。 .丶...	sadness
RIP .......  爱犬买卖 / 领养 / 宠物用品 为什么有那么残忍的人	sadness
獲得控制，正在逐漸康復中，目前仍由台灣動物緊急救援小組安排住院中。如果您想要幫助這隻可憐半臉狗的醫療、安置等費用，可上台灣動物緊急救援小組網站：  加入捐助行列！ at 大葉高島屋 Dayeh-Takashimaya	sadness
 拜託ㄧ定要告知身邊的長輩(///▽///)	sadness
 连我每天参的朋友都不理解我 交来都没什么意思! 最怕的就是 候面讲我一套 前面来跟我讲一套。。 无言 with Sabee LevendaDewz Chin.	sadness
ˋˊ  請肉搜這台車！狗狗的腳跑到流血了！	sadness
 在夜店喧嘩之後⋯每天回家關上門，總覺得好空虛。還好有他一直陪著我！開了門，總會看到他乖乖在門口迎接我回來！但他闖禍時就不會迎接我了⋯屢試不爽～	sadness
 所以我是{ 貪吃的白痴嗎？ }囧	sadness
 感慨，昨天生日從台北回宜蘭突中。因為小弟載重陸續放車。才過幾個彎，前面的小發財真的很雖。被對向重機噴到，重機男當場人首分離，下車一看他的頭飛了，剩下身體在地上。頭在旁邊，腦漿四散一攤血，於是先拜一拜想說要幫忙，結果救護車來五分鐘就走了（應該是直接叫[PERSON] ）。他的家人一定很難過，快過年了，友台一定得多加留意，小心駕駛 ...	sadness
[PERSON] !  一夜努力!只少香港還有一點堅持，支持支持！但聽到仲有人係講緊好悶呀成晚都係佔中有無其他嘢睇呀？仲講緊好驚今日無車呀我今日搵好多錢㗎嗎！革命也許還要多一點的時間吧！	sadness
忙 所以想要一直黏在一起真的很難 遠方的朋友祝福你們 你們現在過得好嗎？	sadness
 愛買是當客人白痴嗎	sadness
 各位朋友請幫我分享轉po讓這個寶貝早日回到家人身邊，能多一個人分享多一份力量，我這邊盡量問誰家的寶貝只希望讓他快回家，這隻女孩蠻乖不會亂叫，很親近人，很規矩	sadness
0000-UP  請肉搜這台車！狗狗的腳跑到流血了！	sadness
R.I.P  願 逝者安息 傷者平安早日康復請大家繼續幫傷者祈禱集氣希望他們早日康復願悲劇不再發生 天佑台灣	sadness
 很憂鬱！都不ㄔ飼料~餓到發抖還是不吃。。。心疼！來幫它買罐頭；它的主人到底在那ㄚ？把它教的很乖還要遺棄它嗎？還是走失的~批踢踢也有他的訊息~ at 寶羅寵物百貨用品店.	sadness
 醫學中心急診室每到假日就成了一般診所。 with 張志華.	sadness
 为什么哭了过后,眼睛会红呢?因为[PERSON] 	sadness
Rest in peace grandpa. Father and grandma is waiting you at the other side.  我慈祥的爷爷，你为什么不让我看你最后一眼！你走得太突然了，我以后再也听不到你说故事了。一路好走。婆婆会在另一边接你。你会永远留在我心中。 at 新安乐慈善居.	sadness
 牠們想要一個家~請用領養代替購買! 【搶救！搶救！！】跪求‧乞求哥哥‧姐姐‧大叔‧大嬸們：緊急搶救支援，幫助受很嚴重的小孩嗎？五分鐘前在柳營的五分車鐵軌上看到的。被補獸夾夾到，感恩。轉po朋友的文章。因為我們都住在台北市。 at 大葉高島屋 Dayeh-Takashimaya.	sadness
 假期的時間……總是過的特別快～回到家鄉感覺特別輕鬆熱情的家人……熱情的招待……熱情的讓我～依依不捨	sadness
無辜的被犧牲了...	sadness
said。。。。  請肉搜這台車！狗狗的腳跑到流血了！	sadness
 動保康樂隊(我們不收捐款 ~也不募款~) 【搶救！搶救！！】跪求，乞求哥哥，姐姐們：這隻小狗狗是在台中市立火葬場的[PERSON] 小孩，背後不知道怎麼了，躺在地上奄奄一息⋯⋯有誰能救救牠，這是無辜的小生命，誰能幫幫牠？ at 天母運動公園法式滾球場.	sadness
Help...  求救～被捕獸夾斷腿。餵食的浪浪找不到00多天了，前幾天工廠的小姐告訴我說，看到被捕獸夾夾到的黑狗，腿已外漏見紅，留下電話請小姐再看到拍照，今天小姐傳訊息照片給艾瑪，看照片好像夾子還在腳上，艾瑪緊急求救幫助救援這隻狗狗。 .	sadness
不要伤害/排挤他们其中一个..唯饭/颜饭 VIP这个称号真的不适合你们VIP是守护、爱、包容BIGBANG五个人的	sadness
縮小，感染狀況已獲得控制，正在逐漸康復中，目前仍由台灣動物緊急救援小組安排住院中。如果您想要幫助這隻可憐半臉狗的醫療、安置等費用，可上台灣動物緊急救援小組網站：  加入捐助行列！ at 大葉高島屋 Dayeh-Takashimaya	sadness
RIP  她是我的常客，那天才遇到她聊得很开心，那天参加比赛还拿到奖，还说越来越漂亮，她说越来越成功了，真的想不到你就这样走了，真的很心痛，不管你在那里都是我我最亲爱的顾客，永远爱你	sadness
(>﹏<)  這樣會得恐慌症吧?!	sadness
Anyone in southern Taiwan who can help?  狗狗認養 有愛心聯誼網 【搶救！搶救！！】跪求‧乞求哥哥‧姐姐‧大叔‧大嬸們：緊急搶救支援，幫助受很嚴重的小孩嗎？五分鐘前在柳營的五分車鐵軌上看到的。被補獸夾夾到，感恩。轉po朋友的文章。因為我們都住在台北市。 at 大葉高島屋 Dayeh-...	sadness
[PERSON]  我愛的Kitty形象崩壞惹，歐不～～～～～	sadness
 這個人情人暖的地方遇見了這麼可愛的兩位老闆，說真的要離開臺南我很不捨很難過，本是一家親這是你們說過的就像家人我也真的把你們看成家人，因為一篇文章找到了你們真的是福氣不再乎什麼就是熱愛服裝，認識了你們也學到很多，有時間我一定常常回來。因為真的太愛你們了，上車也都鼻酸了。 	sadness
RIP  一早起來幫忙很不幸又挖出一具罹難者 at 國際商工.	sadness
No  各位[PERSON] 求求你們大家幫幫牠牠真的被抓進收容所！！真的被抓進去了！！牠真的很親人！！對牠好的人牠真的都知道！會跟牠玩會送東[PERSON] 吃的牠真的都知道！！拜託大家幫我轉分享！！我自己養了三隻我真的不知該怎辦？拜託大家 拜託大家牠一定非常怕非常不安！！牠很乖真的很乖！！	sadness
大,死在籠子裏,來福沒地方住,工廠的主人離開,所有的人都走了來福開始流浪,牠年紀很大了我很不忍,我想幫牠找可信任的中途,讓牠老年能安身立命==================================== 	sadness
looking for new home  請問有冇好心人士可以收留佢呀，因為政府樓唔俾養狗呀！佢喺街度流浪好可憐㗎！佢好乖㗎，唔會咬人㗎。希望有好心人能夠收留佢啦，好心有好報㗎……想要就盡快留言喇，只會養埋呢個禮拜咋！ with Fanny Ngau.	sadness
 害怕受傷害…不敢跟你說(._.)我知道沒辦法逃避，但至少能躲個幾天…如果你沒發現，那我有點想選擇隱瞞，看著你忘了我，看著你尋找到另一個真愛；因為我也不值得被愛…如果可以我想回到過去…	sadness
天下父母心，难道你就是这样回报父亲的吗? 人生短短数年，有生之年，我愿用我十年的光阴，换来父亲的长寿。 但看了这老人，真的很心寒，如果你们有谁觉得他的儿子连畜.生都不如的，就转下去让更多的人看看！	sadness
hi  从昨天[PERSON] 到现在已经是第六次了 我快疯了 到底是怎么了啦	sadness
 牠失蹤了叫球球 約0、0歲穿著白藍色的衣服在后里失蹤了怎麼都找不到 眼睛泛紅了我 球球快回家過年保佑妳吉狗天相 at 家裡.	sadness
Ugly people!!!  轉載網友Meimi Wong.這個不能不轉發，實在太恐怖，本月極品呀 )))))))雪狐，知你死得好慘，個咀變成隻鉗, 夾番自己隻腳, 死左仲要[PERSON] 住, 好慘呀…..頂!!!!希望你安息！** 圖中女子是一個年輕人，我倍覺悲哀！** with Chi Ho Mak and David Wong.	sadness
000 帳號0000000-0000000＊愛護協會確認您的善款入帳後，將會將您的善款紀錄到  ，再煩請您點入查詢唷 ＊關於善款 / 物資捐助說明，可以參考 這篇文章唷 at 天母運動公園法式滾球場	sadness
 大雨大雨何時停。唉 想跑步 想打球 陽光快來吧！	sadness
involved in the accident.And prayers to others to be safe.披著疲累的身軀回到宿舍，原以為可以為一天的勞動得到讓人欣慰的休息，得到的卻是一則晴天霹靂的消息。一位英雄的墜落，哀悼和祈禱，願你得到安息。也祈禱受傷的人早日康復。	sadness
 很多時候的無奈非三言兩語就能說清楚......人有失足~馬有失蹄~沒有十全十美的人生....但是有自覺與反省的未來...	sadness
 今年最後一次自虐結束，還好有在關門前回來，接下來要好好把腳傷養好嚕	sadness
 亲爱的员工朋友们，你们已经保护您的生活稳定的收入(开支增加)？ Ask me HOW to start your PLAN B source income !!Info from my friend-Engineer in Dell Penang 0000 employee fired this morning 新年过了来送分大礼物 omg .	sadness
汰祡戺潬正潭潢摲牥爭摡畩㩳瀲㭸漭戭牯敤慲楤獵㈺硰敷止瑩戭 牯敤慲楤獵㈺硰戻牯敤慲楤獵㈺硰执獧搴摻獩汰祡戺潬正瀻獯瑩潩 㩮敲慬楴敶执獧搴筮楤灳慬㩹湩楬敮戭潬正漻敶晲潬 I Almost Cried Specially When [PERSON] : 汦睯潬正漻敶晲潬 ...	sadness
 【搶救！搶救！！】跪求，乞求哥哥，姐姐們：這隻小狗狗是在台中市立火葬場的流浪狗，背後不知道怎麼了，躺在地上奄奄一息⋯⋯有誰能救救牠，這是無辜的小生命，誰能幫幫牠？  and Judy Chen 	sadness
 又是一窩黑幼幼……什麼時候才能停止啊？真想做個海報內容是關於不結紮又棄養，流浪的毛孩懷孕生下了小狗，小狗進了收容所被安樂，這因果都要算在原飼主身上～還有若民眾做好事，自動幫浪浪結紮，這善事老天爺都會記上一筆～還有莫名就通報抓浪浪的民眾，等於送毛孩去死，就是兇手，老天爺也會看到～	sadness
 ::可以不要这样迟上映吗==回到台湾应该都没有得到看了..希望台湾戏院有！	sadness
 血腥畫面，英俊的臉孔毀容了，very sad. R.I.P	sadness
：0000000000拜託各位幫我分享好嗎	sadness
OMG. RIP teacher!!!!!!!!!!  剛剛學弟簡訊傳來噩耗，我們敬愛的 蕭飛賓老師剛剛過世了，原訂大家一起在這週六下午0:00,去成大醫院探望老師的行程已經暫時取消。由於這是剛剛收到的噩耗，請RPV的大家幫忙傳遞，目前也還不知道老師靈堂會設在哪裡，後續若有訊息會馬上貼在FB給大家知道，再去祭拜老師。	sadness
 這些年來的除夕夜與天公誕的熱鬧，也隨著您無聲的離去而消失……沒有了您，我們也沒在慶祝了。日曆 一天一天地撕去；思念 一天一天地倍增；一天一天儲集著是對您的情；凝結的是對您深深的記憶……可否，不要對我那麼地殘忍……可否，把您以往的愛，再次的給我……可否，讓我再次地看看您……可否…… …… at 蝸牛殼里.	sadness
 早安～各位好朋友們，今天開始寶貝放寒假囉！終於…終於暫時不用那麼的早起床了，但今天要值班所以也起來上班了，>< 話雖如此今天突然天氣000度大轉變，居然會如此的冷，各位好朋友們記得出門多加件保暖衣物才不會受凍喔！	sadness
 一哥 T_T快回家全身白的[PERSON] 牛犬大家幫我轉發謝謝非常焦急的我	sadness
 拜託大家找找我家包子不見了!眼睛有障礙~很溫馴的狗!在仁武八卦一帶不見了~非常擔心!	sadness
與死神的拉鋸戰喔！><☆延伸閱讀／[PERSON] 小孩救援現況： at 大葉高島屋 Dayeh-Takashimaya	sadness
 就是她讓我昨天在所內淚崩殘酷的萬物之靈 卑劣的人性	sadness
 超速~~又0000了~~速限:00公里。機車錶速:000公里。測速相機拍到:00公里。超速:00公里	sadness
~目前確認中.....晚點有消息會跟大家通知!!)以下附上照片~PS:標注到的好朋友們抱歉,因為你們是我最想告知跟請求幫忙的人,請幫我轉PO,或有其他建議跟教導也請告知我!!感激不盡~若有困擾僅可刪除並至上歉意~ . 要分享請點讚~再轉分享~否則一率封鎖!...	sadness
Please help!  主人為何放逐佢、遺棄佢？？？！！！流浪狗狗已被趕走離開我屋苑，""總好過call漁記既(>_<)""。 他在我屋苑附近的行人天橋内，已經不願進食及飲水了，經常低嗚好可憐，他看似開始放棄自己了！！！狠心的主人，你正在扼殺紧你的毛孩！！！有人願意救救他嗎？ .	sadness
 天氣溫差太大～牠今天下午突然停止心跳…今天晚上我回家、無法看到牠再對我撒嬌了、、、	sadness
 今天是個難過的聖誕節……媽媽今天晚上去倒垃圾圈圈開心的跟媽媽下樓去！！就媽媽一個不注意圈圈被附近的一隻大土狗給咬死……急忙的送去醫院……醫生說沒救已經走了難過的哭了好久……也恨那隻夭壽的狗圈圈走了……好不捨因為你一直都好乖好聽話也會保護晅晅~真的好不捨	sadness
電話:0000000000([PERSON] 先生)以下附上照片~PS:標注到的好朋友們抱歉,因為你們是我最想告知跟請求幫忙的人,請幫我轉PO,或有其他建議跟教導也請告知我!!感激不盡~若有困擾僅可刪除並至上歉意~ . 要分享請點讚~再轉分享~否則一率封鎖!...	sadness
RIP to MH00  为机上的搭客及机组所有的人员祈祷。多少人心碎了？我们的心同样碎了，000 人命。最不想看见的事情，我们都沉痛。	sadness
。例如我會幫熱炒快起鍋的青菜滴少許優質橄欖油，或在選取牛排時，先去掉粗筋，好凸顯它的嫩度。總之，對廚界再怎麼幻滅，我相信還是有像我這樣願意多做一道功夫，不被化學添加物綁架的傻子。其實越來越多主廚與我想法一樣，我期待台灣的料理界，未來會以標榜「原汁原味」為傲，當客人上門時，都能問心無愧地說：「歡迎光臨！」来源：今周刊 with Kian Heng Kong and...	sadness
我	sadness
Sean Lee  好想在這環境下度假喔~可惜沒有另一伴的陪伴!	sadness
 我的寶貝不見了請大家幫忙我找找！名：史努比年齡：三歲品種：白博美特徵：白色、長毛、眼睛有淚橫、脖子戴有黑色皮項圈銀色吊牌遺失時間：00月00日星期五早上0點00分遺失地點：重慶北路000巷和迪化二街口	sadness
r.i.p  马航MH000 - 000个生命，全机无人生还,我真的无法接受 (ㄒoㄒ)今天 00.00 电台播放的歌很DOWN，昨晚到现在的心情很不好 〒_〒 鸣~~ 全世界的人都很悲伤 -︵- . 喜歡就按个【Like】<0<0 喜歡就【share】吧 ～拿圖請留言～	sadness
，忽然從一旁跑出來干案的。这是一個新的打劫伎倆，上個星期五有人看見過他們用同樣的手法在USJ那帶出現，昨天也在Dataran Prima出現。大家一定要小心！尤其是女士，同情歸同情，也要注意本身的安全。	sadness
法人台南市流浪動物愛護協會(0) 台新銀行帳號000 永福分行0000-00-0000000-0(0)郵政劃撥-00000000(0)郵局000 帳號0000000-0000000＊愛護協會確認您的善款入帳後，將會將您的善款紀錄到  ，再煩請您點入查詢唷 ＊關於善款 / 物資捐助說明，可以參考 這篇文章唷 at 大葉高...	sadness
我們外婆只剩半年，外婆積極治療撐過了六個年頭。這次醫生在0/00宣布外婆只剩三天時，外婆還是撐到了今天。外婆真的很努力，雖然戴著氧氣罩，我們在鼓勵她的時候，她為了讓我們安心還是一直點頭回應著。外婆真的累了。她去找外公一起做快活的天使了。我們真的好想妳⋯好想好想⋯真的好痛哦。婆婆，我愛妳。	sadness
 夜色 無 永遠豔麗 心情 無 永遠美麗人生永遠不滿足我 就是不滿足 的那一族 希望你們不要像我不滿足～晚安好友	sadness
[PERSON] Mui, Candy Cheang, Ivy Cheang, our new house need more safety.  可怜。。。孩子的爸爸妈妈心痛无比还温馨的提醒大家, 希望大家要万分注意孩子的安全。 我也希望这孩子安息, 当个快乐的小天使, 假以他日有缘, 他会回到她父母身边再续前缘。孩子的家人，你们要坚强。	sadness
 認養與愛護流浪動物愛心實現團 【搶救！搶救！！】跪求‧乞求哥哥‧姐姐‧大叔‧大嬸們：緊急搶救支援，幫助受很嚴重的小孩嗎？五分鐘前在柳營的五分車鐵軌上看到的。被補獸夾夾到，感恩。轉po朋友的文章。因為我們都住在台北市。 at 大葉高島屋 Dayeh-Takashimaya.	sadness
Pls help  寵物行為交流區 大家好~~是因本人唔見左隻狗仔..所以想借地方po文...真係唔好意思!!我唔見隻玩具貴婦狗 名叫[PERSON] 0個月大係司打口公園唔見由0月00號至今還沒找到!!!請求幫忙分享..如有消息請電:00000000...重酬!!!謝謝..	sadness
Pray for TAIWAN  願 逝者安息 傷者平安早日康復請大家繼續幫傷者祈禱集氣希望他們早日康復願悲劇不再發生 天佑台灣	sadness
.org.tw/Joomla_000/index.php?option=com_content&view=article&id=0000:0000000&catid=000:00000&Itemid=000(影片)搶救六龜的孩子：： at 大葉高島屋 Dayeh-...	sadness
與 滄傷 ～在這三年流失的情感：走失的年月裡《烙得很深很深的傷口 ：情感痕跡【份量：變得很重很重	sadness
一生，但是我們可以！狗是人類最忠實的夥伴…喜歡狗狗的你們，快來領養牠們吧！	sadness
Urgent need foster  得幾個月石罅小妹妹，聽日便放回最督處，以後流浪生活，好好保重了 !	sadness
 有人知道依娜在哪請快跟我們聯絡，她前天晚上失蹤到現在[PERSON] 回家…手機也打不通…我們家人都很著急而且也報警處理了，所以請知道他下落的人請快聯絡我們或留言，她身上穿得全身都是黑色…娜娜你如果看到快跟姊姊聯絡，大家都很擔心！有什麼事回來在說不要義氣用事了…看到此文麻煩幫我分享…謝謝  .	sadness
Help she.  親愛的朋友們：我昨天在北科大中正館遺失我的寶貝銀色錄音筆還有寶貝化妝品（黑色小提袋）嗚嗚…人家外出帶的化妝品可是濃縮精華版的，根本就是寶物一袋！！不知道是哪個幸運兒撿到我的名牌寶物拜託我好想它們！！快還回來：（雖然我今天已經網路下單買新的了。但用過了會有感情的！！！（拜託大家幫我轉貼，助尋寶）	sadness
 到了要吃保健藥品的時候了？武田製藥出品 アりナミン EX PLUS	sadness
 再補一張更醜的……為了表示我的誠意	sadness
Well as well  回来kl的第一个晚上,没有你睡在身边,妈妈整晚睡不着,宝宝你可否睡好?妈妈想你,你是否有想妈妈? with Joseph Toh Han Guan.	sadness
Help  全民要求政府，停止殺戮！！！停止撲殺流浪狗！！！ 【搶救！搶救！！】跪求‧乞求哥哥‧姐姐‧大叔‧大嬸們：緊急搶救支援，幫助受很嚴重的小孩嗎？五分鐘前在柳營的五分車鐵軌上看到的。被補獸夾夾到，感恩。轉po朋友的文章。因為我們都住在台北市。 at 大葉高島屋 Dayeh-Takashimaya.	sadness
了这老人，真的很心寒，如果你们有谁觉得他的儿子连畜.生都不如的，就转下去让更多的人看看！	sadness
For Kuching ppl..  亲爱的朋友们，谁有B+血型请帮忙捐血给Kuching 政府医院的LEONG KAO FUNG 00岁（只需要B+血型里的血小板，所以只能B+血型的捐者）leong kao fung 是我小学，中学一起长大的朋友，希望可以帮助他。我是O+，同时也不在古晋。拜托了，大家。 .	sadness
？？？  尋貓:小甜甜，別名:小可愛，波斯貓，年約0至0歳，身體特徵，面向石手邊耳朵有牙齒咬斷位，肚仔有約三吋長的開腔手術縫合位，因為她有胰臓病，雖長期食藥，而且每日食量需不少於兩大罐kakato雞。另外加餐。走失時間0000-0-0，晚上六點半至七點左右。地點：觀塘和樂邨。如有發現，請聯絡陳小姐00000000，重酬！	sadness
=b0000000000.慈音園購地專戶 彰化銀行代號：000帳號：0000-00-00000-0-00 戶名：新北市保護動[PERSON] ** 愛心幫助後請告訴我們 後五碼 / 金額 / 姓名 / 住址 / 用途 ，以利開立收據，謝謝 	sadness
 刚从客户office出来就看到抢劫！新的抢劫流程！车撞摩托抢摩托的东西！还把摩托撞进车底！当我们一群人上前抢匪已上车逃脱！好采摩托人没事送院！坐摩托的人现在都要小心！	sadness
 清晨又被這隻唉嚎的狗狗叫醒.準備了水和食物就衝去尋找他.他似乎又餓了幾個晚上.我沒有辦法帶他回家.只能盡量幫助他不讓他[PERSON] ：三重區光明路00巷附近時間:約上午0:00特徵：柴犬的體型.哈士奇的臉.男生.走路腳有一點點受傷麻煩各位轉貼幫他找主人	sadness
 騎車騎那麼快還蛇行超車 害一個老[PERSON] 摔到滿臉是血牙齒都斷掉了還肇事逃逸害我現在要在警察局看監視器找你這個人渣！絕對要抓到你！！！！！看[PERSON] 都快昏過去了真的很心痛希望阿伯沒有大礙....有沒有下午00：00分經過辛亥路000號路口的好心人又剛好有行車記錄器的拜託幫幫忙＞＜0000/00/00 at 文山二交通分隊.	sadness
 今天吃了…八顆大湯圓。00幾顆小湯圓…現在真的是很不舒服。我想想這樣下去不行不行0000年0/0日如果我在這樣吃宵夜。亂吃一通我就決定要。。。自盡! (＞﹏＜)	sadness
Really or not? Omg  Rip...不会忘记童年时代你给过我们的欢乐	sadness
，這樣邏輯才對，也才能，得分。」半夜睡不著很想找妳一起唱國歌的爸爸留～本文轉載自《天下雜誌》 	sadness
。市民遇到一點點限制就躁怒，甚至不再守法。	sadness
R.I.P  跟大家公布个坏消息。我们的马航载有000个人000乘客，00名机组人员的波音000飞机在俄罗斯和乌克兰边界失联，乌克兰称被恐怖分子击落。我们为逝者祈祷，家属节哀。	sadness
[PERSON]  原來最難過的不是離別	sadness
R.I.P Teacher Jimmy :(  可怜的老师啊T_T	sadness
Pls to share with your fren.  我妹到现在都还没找到 ，希望大家能帮上忙 ，please share it out	sadness
兇手的偏差心路歷程。這些都是我們的孩子，我們給了他們什麼，他們就長成什麼？！在驚慌錯愕、面對這樁不幸悲劇之餘，我總在想：我們為人父母的總能再多做些什麼？！防範些什麼？ 	sadness
飯。K想問眾人聯絡方法；對不起，他們無手提電話。或許，這是最後一次聯絡/見面。緣散。抱著囡囡看這幅圖，告訴她發生什麼事，我只可以說﹕「我地好幸福！」 	sadness
 [闪电]急事[闪电] 00/00/0000星期五 WTL0000 TOYOTA VIOS TRD〈黑色〉 以给沒良心得人被偷走了 发生在salak south garden 本人希望好心人可以帮忙留意 真心感激各位出一份力 如有看见这台车 请紧急撥打以下電話：000-0000000/00000000000 [大哭]请谢绝玩弄[大哭]	sadness
的你，做一些小小爱心，帮助我们。将这篇文章宣传出去，让更多的人看到也能和拥有爱心的你一样给我们帮助。谢谢大家。 .丶...	sadness
 00號禮拜五早上誰有空要出公祭麻煩兄弟們相挺拜託了有空的私密一下！！感謝！！ at 兄弟相挺的雙手.	sadness
Oh My......GD  购买此款可与GD共进晚餐 并由他亲自为您佩戴 大概是马币RM000	sadness
 酒駕害死人 一死三傷！！請問你用什麼來賠償？這四個無辜的家庭………酒後不開車 開車不喝酒	sadness
 拜託住永康台南應用科大附近的的朋友幫我找一下我的貓咪 我的貓咪今天不知道從陽台跳去哪裡了 我回到家就不見了, 拜託 幫我轉貼拜託拜託	sadness
轉發讓更多人知道，希望能有行經的車輛有拍到意外當時畫面!!謝謝 with 莫失心	sadness
Adopt a JB pup...Give them Homes...  有谁要领养流浪的小狗。姓别：母 地址： E-00-00,jalan EJ0/0.taman ehsan jaya,00000 johor bahru，电话：要养的直接打给我0000000000他们很可怜 	sadness
We are Taiwan black bear , only 000 No. Is left today !You all love Panda, how about us?  (黑熊)是台灣的國寶為什麼不注重牠新聞都是黃色小鴨 熊貓怎麼不報導台灣(黑熊)台灣媒體請多關心自己的國家小黑熊(黑糖)也非常可愛 也很萌的請多分享出去	sadness
 全民要求政府，停止殺戮！！！停止撲殺流浪狗！！！ 【搶救！搶救！！】跪求‧乞求哥哥‧姐姐‧大叔‧大嬸們：緊急搶救支援，幫助受很嚴重的小孩嗎？五分鐘前在柳營的五分車鐵軌上看到的。被補獸夾夾到，感恩。轉po朋友的文章。因為我們都住在台北市。 at 大葉高島屋 Dayeh-Takashimaya.	sadness
Upset....  【請尊重小動物，請尊重生命！】狗狗真係唔想死係港鐵路軌，好想爬番上月台架！點解港鐵你要下令開動列車, 蓄意輾死狗狗「未雪」？你於心何忍呀？人性何在呀？圖片來源：Eric Lai Wing On . 福妹的故事 	sadness
 協尋。 0/0早上於桃園市泰昌三街散步，被ㄧ台機車撞到，嚇到ㄧ直跑，遍尋不到，麻煩住附近的朋友幫我留意轉發，讓我早點找到女兒。 特徵:眼睛ㄧ大ㄧ小，肚子皮膚有黑色素沈澱，有用咖啡色項圈，愛與人玩。聯絡電話:0000000000莊君瑤聯絡 .	sadness
 開到一半沒煞車，原來煞車油漏光了⋯	sadness
 【 0個葬禮0個失禮】一家人齊齊整整，卻雞犬不寧， 鳴呼哀哉！ 	sadness
一点是我们的一大点。）若有任何机构/NGO/社团想要参与或筹款等等，你们可以联络我 Lobin（000-0000000）或我的母亲[PERSON] ）我们可以给你更多详情以及有关资料。也希望看着这篇文章的你，做一些小小爱心，帮助我们。将这篇文章宣传出去，让更多的人看到也能和拥有爱心的你一样给我们帮助。谢谢大家。	sadness
Jason Lin e00  人家說交往久了，會有夫妻臉，本來我不信的。。。。 at 新莊生命紀念館. 就手機上傳還要解釋啥！	sadness
爭端，就不會在那裡結惡緣。』我會遵循 上人的慈示 行於菩薩道 利益人群 今日僅以清香一柱跟您 叩首 感恩您的養育之恩 ! with Jennifer Chang and 註帳戶	sadness
 痛死了…终于扭伤了！干…真的很危险咯…打球而已…要打到这么恐怖的么…我还不想进医院勒…拜托…这是我这么久以来最怕手肘的一次…我要走路…我要外拍…我要走街-_-||	sadness
 人與人之間、因為不信任、猜忌…所以有了爭執、一但心累了、於是…漸沉默了、不在乎了…“聚時盡其在人、散時盡其在我”…沒有什麼是永恆…一切隨緣～ at 竹圍溫暖的窩.	sadness
很鬱結。將 Choppervy Ng之前叫我代分享的，透過K分給眾人。小量現金，可能只夠買一套衣服和吃一餐熱飯。K想問眾人聯絡方法；對不起，他們無手提電話。或許，這是最後一次聯絡/見面。緣散。抱著囡囡看這幅圖，告訴她發生什麼事，我只可以說﹕「我地好幸福！」 	sadness
，您听见了吗？	sadness
 我覺得我好受傷◯rz	sadness
RIP George.........  世界最大狗狗 George 過世了	sadness
狗狗還有貓咪，阿姨甚至連烏龜鴿子都有救，很有愛心吧!你們可不可以幫忙阿姨捐點衣服，罐頭，報紙，或者能力範圍可以的金錢都可以，拜託大家!拜託謝謝 	sadness
 社團法人[PERSON] 狗幸福協會 【搶救！搶救！！】跪求‧乞求哥哥‧姐姐‧大叔‧大嬸們：緊急搶救支援，幫助受很嚴重的小孩嗎？五分鐘前在柳營的五分車鐵軌上看到的。被部獸夾夾到，感恩。轉po朋友的文章。因為我們都住在台北市。 at 大葉高島屋 Dayeh-Takashimaya.	sadness
 百元救狗團 【搶救！搶救！！】跪求，乞求哥哥，姐姐們：這隻小狗狗是在台中市立火葬場的[PERSON] 小孩，背後不知道怎麼了，躺在地上奄奄一息⋯⋯有誰能救救牠，這是無辜的小生命，誰能幫幫牠？ at 天母運動公園法式滾球場.	sadness
 有網友捷圖這種東西給我...拜託我幫高調...看看那罐子內的霧氣!貓咪根本就不能呼吸了吧!這樣貓咪會很痛苦的...難道這樣很好玩嗎?	sadness
参与或筹款等等，你们可以联络我 Lobin（000-0000000）或我的母亲[PERSON] ）我们可以给你更多详情以及有关资料。也希望看着这篇文章的你，做一些小小爱心，帮助我们。将这篇文章宣传出去，让更多的人看到也能和拥有爱心的你一样给我们帮助。谢谢大家。	sadness
Rip  各位[PERSON] 的好朋友..他的告別式將在0/00星期日，下午0點.在台北市第二殯儀館至孝廳舉行告別式..請大家送他最後ㄧ程..有需要聯絡的請聯絡我，謝謝 with 肯尼斯.	sadness
ㄍㄢ  請肉搜這台車！狗狗的腳跑到流血了！	sadness
 這群母帶子，是剛被捉進去的，狗媽媽大多數都可以逃脫的，但是都為了小狗一起被捉.........有聽過狗媽媽因為小狗都被捉了而因此乖乖上車的故事嗎？ 救救牠們吧， 沒被安樂前的日子都過得生不如死的， 牠們目前在大山腳mpsp. 如果你可以暫時寄養， 讓我們幫忙找領養人和負責結紮， 我們提供津貼和狗糧， 救救牠們吧！	sadness
ㄞ  我的手機我的腳受傷了。˙˙˙˙˙真是很痛	sadness
 我們家柴犬叫狗狗剛剛在體育場不見了！請大家幫忙分享…有消息快連絡我們0000000000	sadness
R.I.P  在生时，您不分种族为马来西亚人付出。您的敢怒敢言，深深的留在我的脑海里，我以您为榜样。您永远是人民心目中的老虎和英雄。安息吧，战士！永远悼念。。。	sadness
WTF！！！！  爱犬买卖 / 领养 / 宠物用品 为什么有那么残忍的人	sadness
 收費及愛心中途 資訊 【搶救！搶救！！】跪求‧乞求哥哥‧姐姐‧大叔‧大嬸們：緊急搶救支援，幫助受很嚴重的小孩嗎？五分鐘前在柳營的五分車鐵軌上看到的。被補獸夾夾到，感恩。轉po朋友的文章。因為我們都住在台北市。 at 大葉高島屋 Dayeh-Takashimaya.	sadness
客機墜毀后所攝。也有未经证实的报道指客机是在乌克兰靠近俄罗斯的边境被射下来。	sadness
 小坏蛋Doidoi 不见了T.T名字Doidoi 年龄0岁颜色深巧克力色 颈项带着红色色带失踪日期00/00/0000 大年初三失踪时间大约傍晚00:00地点大马花园 kota tinggi jalan berlian麻烦好心人士捡到的人还给主人联络000-0000000 / 000-0000000Pls share.. thanks...感激。。。	sadness
 這世上最遠的距離 不是生與死而是 妳就在我面前 卻不能告訴妳 我愛妳 at 叫倫的地盤.	sadness
她真的不在乎你了的那天你真的希望她再也不哭再也不動不動就生氣了嗎 !?好的 等她真的被你傷透了麻木了的那天你真的在考慮要不要跟她分手了嗎 !?好的 祝你在很久很久以後的某一天 不要後悔	sadness
革命就是要流血 那都流血了 你們的心不痛嗎 告訴你我的心是揪著的 這是該正面解決的問題啊 這個黑色星期一值得審思 希望世界看到台灣人民捍衛主權的決心 pray for taiwan taiwan is taiwan An independent country	sadness
幫忙轉發 ....我先去哭了拜 心有餘而力不足感覺真的很討厭..小俏妞是在高雄被撿到的哦	sadness
只夠買一套衣服和吃一餐熱飯。K想問眾人聯絡方法；對不起，他們無手提電話。或許，這是最後一次聯絡/見面。緣散。抱著囡囡看這幅圖，告訴她發生什麼事，我只可以說﹕「我地好幸福！」 	sadness
 买不到两个星期就变成这样。offer的东西真的不能买。朋友们如果你们看到offer到很离谱的东西千万不要买。	sadness
Pray~~~  今天的心情。无法想象。答案让我太不满意了。。感觉人类好无助。。	sadness
！請幫忙留意轉po謝謝了  	sadness
 這隻[PERSON] 小孩被遺棄了！我中午就看到牠在這徘徊非常焦慮！一直在等主人的樣子，就這樣一直在雨中淋雨，我叫牠過來牠也不理我，我走過去牠就跑走，有沒有人認識牠呀～看了真的很心酸 (´Д｀。)	sadness
